"edon","munn","edo","mun","pena","jvm","amlo","panal","efec","lisnom"
1,1,"ags","AGUASCALIENTES",124811,107657,79179,19694,331341,556599
1,2,"ags","ASIENTOS",7524,5989,2186,1766,17465,29290
1,3,"ags","CALVILLO",9256,8827,2772,1414,22269,41859
1,4,"ags","COSIO",3213,1530,560,773,6076,10133
1,5,"ags","JESUS MARIA",14482,13043,5423,1830,34778,60494
1,10,"ags","SAN FRANCISCO DE LOS ROMO",6401,3429,1909,1134,12873,22911
1,6,"ags","PABELLON DE ARTEAGA",7664,2675,3131,2745,16215,26783
1,7,"ags","RINCON DE ROMOS",8334,4156,3432,2505,18427,32553
1,8,"ags","SAN JOSE DE GRACIA",1505,889,1025,480,3899,6013
1,9,"ags","TEPEZALA",3754,2440,1214,822,8230,13264
1,11,"ags","EL LLANO",3770,1703,1671,534,7678,12774
2,1,"bc","ENSENADA",70818,41584,67755,4822,184979,334322
2,2,"bc","MEXICALI",148946,119928,89359,9712,367945,669241
2,3,"bc","TECATE",18509,10837,10003,1010,40359,76080
2,4,"bc","TIJUANA",216501,161052,212599,18619,608771,1169190
2,5,"bc","PLAYAS DE ROSARITO",12931,9305,13630,1033,36899,74402
3,1,"bcs","COMONDU",14371,10803,4728,450,30352,48197
3,2,"bcs","MULEGE",9904,6836,4420,500,21660,35658
3,3,"bcs","LA PAZ",45463,28064,31740,2325,107592,173950
3,4,"bcs","LOS CABOS",31754,27347,21771,1615,82487,161770
3,5,"bcs","LORETO",3748,2463,942,82,7235,10767
4,1,"cam","CAMPECHE",48413,31540,37243,3672,120868,182795
4,2,"cam","CALKINI",13204,8077,6829,1076,29186,36367
4,3,"cam","CARMEN",30023,24802,32301,1787,88913,153211
4,10,"cam","CANDELARIA",7400,5506,3886,179,16971,27309
4,4,"cam","CHAMPOTON",16845,13812,7805,748,39210,57194
4,9,"cam","ESCARCEGA",9843,7416,5321,301,22881,35391
4,11,"cam","CHAMPOTON",4890,2672,2829,250,10641,15400
4,5,"cam","HECELCHAKAN",6375,4974,3071,1207,15627,19660
4,6,"cam","HOPELCHEN",7897,6276,2186,334,16693,23102
4,7,"cam","PALIZADA",2389,1408,1114,59,4970,6295
4,8,"cam","TENABO",2948,2078,594,174,5794,7088
5,1,"coa","ABASOLO",386,280,39,5,710,1067
5,2,"coa","ACU�A",23216,14342,11226,1328,50112,97348
5,3,"coa","ALLENDE",4305,4370,1017,163,9855,16041
5,4,"coa","ARTEAGA",5982,3766,846,115,10709,16501
5,5,"coa","CANDELA",578,441,37,9,1065,1580
5,6,"coa","CASTA�OS",5203,3576,2258,133,11170,19183
5,7,"coa","CUATROCIENEGAS",2695,2259,497,59,5510,8425
5,8,"coa","ESCOBEDO",761,556,86,4,1407,2217
5,9,"coa","FRANCISCO I. MADERO",12663,7497,5049,739,25948,37977
5,10,"coa","FRONTERA",10934,11529,6517,523,29503,52573
5,11,"coa","GENERAL CEPEDA",2518,2824,278,45,5665,8488
5,12,"coa","GUERRERO",616,341,56,3,1016,1678
5,13,"coa","HIDALGO",555,127,37,10,729,1061
5,14,"coa","JIMENEZ",2789,1456,308,40,4593,7548
5,15,"coa","JUAREZ",486,291,137,9,923,1322
5,16,"coa","LAMADRID",490,524,97,7,1118,1505
5,17,"coa","MATAMOROS",19680,15706,9893,1032,46311,71523
5,18,"coa","MONCLOVA",29872,38197,20625,1678,90372,153823
5,19,"coa","MORELOS",1630,1730,325,39,3724,5992
5,20,"coa","MUZQUIZ",13200,12085,3772,477,29534,48626
5,21,"coa","NADADORES",1465,1025,421,46,2957,4639
5,22,"coa","NAVA",4683,4350,1557,166,10756,16998
5,23,"coa","OCAMPO",1999,1556,410,28,3993,6727
5,24,"coa","PARRAS",8777,7706,2740,547,19770,30938
5,25,"coa","PIEDRAS NEGRAS",24142,26115,9896,1417,61570,114001
5,26,"coa","PROGRESO",1171,542,114,13,1840,2844
5,27,"coa","RAMOS ARIZPE",10098,10034,3754,498,24384,45669
5,28,"coa","SABINAS",10579,12518,3571,625,27293,43870
5,29,"coa","SACRAMENTO",637,396,98,13,1144,1726
5,30,"coa","SALTILLO",123035,110963,55466,9124,298588,486606
5,31,"coa","SAN BUENAVENTURA",4265,3602,1482,224,9573,15986
5,32,"coa","SAN JUAN DE SABINAS",9036,8367,2873,439,20715,32153
5,33,"coa","SAN PEDRO",18158,13557,12154,1043,44912,69474
5,34,"coa","SIERRA MOJADA",1274,598,441,33,2346,3432
5,35,"coa","TORREON",100960,99858,74819,7088,282725,443974
5,36,"coa","VIESCA",4946,3306,1180,119,9551,14048
5,37,"coa","VILLA UNION",1267,1441,171,30,2909,4745
5,38,"coa","ZARAGOZA",2041,3176,408,64,5689,9516
6,1,"col","COLIMA",29642,25014,19687,1345,75688,114568
6,2,"col","COMALA",5027,4482,1422,109,11040,15448
6,3,"col","COQUIMATLAN",4496,4383,1179,101,10159,15020
6,4,"col","CUAUHTEMOC",6162,4385,3240,185,13972,21180
6,5,"col","VILLA DE ALVAREZ",20317,15834,14812,1226,52189,80687
6,6,"col","ARMERIA",6171,4233,2242,174,12820,21032
6,7,"col","IXTLAHUACAN",1701,1400,348,18,3467,4841
6,8,"col","MANZANILLO",27574,25203,17238,1163,71178,116327
6,9,"col","MINATITLAN",2519,1155,716,42,4432,6384
6,10,"col","TECOMAN",20474,15305,7394,515,43688,76408
7,1,"cps","ACACOYAGUA",3877,1346,1682,63,6968,10601
7,2,"cps","ACALA",5560,3092,4388,388,13428,20120
7,3,"cps","ACAPETAHUA",5089,3527,2888,647,12151,18021
7,4,"cps","ALTAMIRANO",6688,3428,1738,52,11906,16097
7,5,"cps","AMATAN",4621,1204,2375,147,8347,11485
7,6,"cps","AMATENANGO DE LA FRONTERA",6546,1055,5616,94,13311,18589
7,7,"cps","AMATENANGO DEL VALLE",2433,171,1214,29,3847,4993
7,8,"cps","ANGEL ALBINO CORZO",5873,3654,3953,705,14185,20020
7,9,"cps","ARRIAGA",7170,4911,4757,908,17746,28732
7,10,"cps","BEJUCAL DE OCAMPO",1176,235,980,6,2397,4445
7,11,"cps","BELLA VISTA",4343,814,3171,362,8690,12353
7,12,"cps","BERRIOZABAL",7183,2536,4261,963,14943,24357
7,13,"cps","BOCHIL",5928,1965,5038,269,13200,17896
7,14,"cps","EL BOSQUE",3577,1569,2010,191,7347,11919
7,15,"cps","CACAHOATAN",7596,5158,6364,169,19287,28172
7,16,"cps","CATAZAJA",4156,1885,2842,121,9004,12134
7,17,"cps","CINTALAPA",15376,3942,10639,845,30802,52046
7,18,"cps","COAPILLA",2162,501,1420,13,4096,4997
7,19,"cps","COMITAN DE DOMINGUEZ",28826,7180,17979,1236,55221,90237
7,20,"cps","LA CONCORDIA",10852,3372,3343,1148,18715,28593
7,21,"cps","COPAINALA",5516,1519,3052,134,10221,13628
7,22,"cps","CHALCHIHUITAN",3092,266,3136,35,6529,8459
7,23,"cps","CHAMULA",21854,4105,3803,182,29944,46423
7,24,"cps","CHANAL",2291,213,1782,15,4301,5777
7,25,"cps","CHAPULTENANGO",1328,711,1125,130,3294,4341
7,26,"cps","CHENALHO",12853,619,2758,79,16309,24745
7,27,"cps","CHIAPA DE CORZO",17791,4988,11314,418,34511,54645
7,28,"cps","CHIAPILLA",1326,1100,527,13,2966,4121
7,29,"cps","CHICOASEN",1302,937,374,17,2630,3860
7,30,"cps","CHICOMUSELO",6427,1448,5829,194,13898,20281
7,31,"cps","CHILON",26527,2299,12819,210,41855,58321
7,32,"cps","ESCUINTLA",5776,2213,3587,387,11963,19295
7,33,"cps","FRANCISCO LEON",938,1124,1205,8,3275,3861
7,34,"cps","FRONTERA COMALAPA",10285,2556,9309,2467,24617,41049
7,35,"cps","FRONTERA HIDALGO",2258,2308,1198,93,5857,8298
7,36,"cps","LA GRANDEZA",1580,284,686,7,2557,4030
7,37,"cps","HUEHUETAN",6957,1777,6090,183,15007,23693
7,38,"cps","HUITIUPAN",4981,849,3692,255,9777,13179
7,39,"cps","HUIXTAN",4098,350,4070,254,8772,12218
7,40,"cps","HUIXTLA",10915,5943,4499,219,21576,35415
7,41,"cps","LA INDEPENDENCIA",11154,2432,4308,109,18003,25777
7,42,"cps","IXHUATAN",2455,500,1530,25,4510,5948
7,43,"cps","IXTACOMITAN",2072,1256,1350,49,4727,6583
7,44,"cps","IXTAPA",3912,2694,4582,98,11286,15167
7,45,"cps","IXTAPANGAJOYA",1412,1002,374,3,2791,3481
7,46,"cps","JIQUIPILAS",12697,2812,3848,179,19536,27720
7,47,"cps","JITOTOL",3296,1069,3009,465,7839,9595
7,48,"cps","JUAREZ",4503,1434,3065,425,9427,14066
7,49,"cps","LARRAINZAR",7772,336,1437,42,9587,13704
7,50,"cps","LA LIBERTAD",1626,1307,727,7,3667,4303
7,51,"cps","MAPASTEPEC",6661,4300,5605,463,17029,29295
7,52,"cps","LAS MARGARITAS",34351,4933,12343,1094,52721,72532
7,53,"cps","MAZAPA DE MADERO",1817,197,1839,12,3865,5341
7,54,"cps","MAZATAN",6104,2185,3585,170,12044,17585
7,55,"cps","METAPA",1381,810,636,132,2959,4157
7,56,"cps","MITONTIC",2816,276,399,20,3511,5104
7,57,"cps","MOTOZINTLA",12746,2364,9626,181,24917,42596
7,58,"cps","NICOLAS RUIZ",304,51,1015,4,1374,2512
7,59,"cps","OCOSINGO",32727,14412,21842,6535,75516,125859
7,60,"cps","OCOTEPEC",2683,99,2068,5,4855,6201
7,61,"cps","OCOZOCOAUTLA DE ESPINOSA",14870,6244,9283,1235,31632,51493
7,62,"cps","OSTUACAN",4178,1722,1595,520,8015,11203
7,63,"cps","OSUMACINTA",1117,734,211,9,2071,2520
7,64,"cps","OXCHUC",9079,675,7207,2730,19691,29004
7,65,"cps","PALENQUE",13702,8464,20141,486,42793,69910
7,66,"cps","PANTELHO",4073,189,3607,14,7883,10620
7,67,"cps","PANTEPEC",1708,1394,1188,53,4343,6459
7,68,"cps","PICHUCALCO",6147,3502,3998,492,14139,21158
7,69,"cps","PIJIJIAPAN",10237,3708,6609,333,20887,34151
7,70,"cps","EL PORVENIR",2835,290,2564,27,5716,7995
7,71,"cps","PUEBLO NUEVO SOLISTAHUACAN",5238,1782,2488,234,9742,16284
7,72,"cps","RAYON",1539,984,1302,45,3870,4964
7,73,"cps","REFORMA",5800,2669,8903,224,17596,25369
7,74,"cps","LAS ROSAS",5609,1020,3652,124,10405,15198
7,75,"cps","SABANILLA",5702,835,5818,15,12370,14968
7,76,"cps","SALTO DE AGUA",11692,2273,10341,132,24438,34824
7,77,"cps","SAN CRISTOBAL DE LAS CASAS",28128,7226,30889,1498,67741,111346
7,78,"cps","SAN FERNANDO",8692,2479,3421,206,14798,21304
7,79,"cps","SAN JUAN CANCUC",7441,1946,3123,135,12645,16673
7,80,"cps","SAN LUCAS",1295,856,876,86,3113,4065
7,81,"cps","SILTEPEC",8299,1861,4522,167,14849,22928
7,82,"cps","SIMOJOVEL",9379,1290,5307,1610,17586,24991
7,83,"cps","SITALA",3107,64,2808,5,5984,6951
7,84,"cps","SOCOLTENANGO",4503,1612,1893,83,8091,11676
7,85,"cps","SOLOSUCHIAPA",1797,1365,909,9,4080,5209
7,86,"cps","SOYALO",2236,566,1506,340,4648,6171
7,87,"cps","SUCHIAPA",4631,2044,3331,144,10150,13730
7,88,"cps","SUCHIATE",5512,4260,2584,156,12512,19480
7,89,"cps","SUNUAPA",801,256,167,110,1334,1671
7,90,"cps","TAPACHULA",46622,35856,36392,2140,121010,202780
7,91,"cps","TAPALAPA",1245,188,985,11,2429,3011
7,92,"cps","TAPILULA",1810,1191,1637,49,4687,7300
7,93,"cps","TECPATAN",11111,1747,4607,755,18220,25691
7,94,"cps","TENEJAPA",9972,1221,3836,122,15151,21621
7,95,"cps","TEOPISCA",8704,1757,2936,291,13688,20339
7,96,"cps","TILA",16533,3696,7487,139,27855,40911
7,97,"cps","TONALA",14207,9367,11501,898,35973,60879
7,98,"cps","TOTOLAPA",1659,209,1236,9,3113,4314
7,99,"cps","LA TRINITARIA",25029,3181,6568,445,35223,49138
7,100,"cps","TUMBALA",9133,992,4503,150,14778,19110
7,101,"cps","TUXTLA CHICO",7270,5363,4195,236,17064,25984
7,102,"cps","TUXTLA GUTIERREZ",77493,33265,96826,4182,211766,380367
7,103,"cps","TUZANTAN",5736,2959,2837,87,11619,17789
7,104,"cps","TZIMOL",4717,723,1766,154,7360,9891
7,105,"cps","UNION JUAREZ",2654,1703,2441,129,6927,10063
7,106,"cps","VENUSTIANO CARRANZA",11135,4415,6829,811,23190,38304
7,107,"cps","VILLACOMALTITLAN",5182,2252,3603,773,11810,19100
7,108,"cps","VILLA CORZO",13682,8032,9778,507,31999,48979
7,109,"cps","VILLAFLORES",15451,12428,11685,1045,40609,66550
7,110,"cps","YAJALON",6232,1839,5133,226,13430,21462
7,111,"cps","ZINACANTAN",10837,449,7856,58,19200,21733
8,1,"cua","AHUMADA",3422,952,583,115,5072,8289
8,2,"cua","ALDAMA",4917,2365,1538,267,9087,16681
8,3,"cua","ALLENDE",2408,728,561,192,3889,6811
8,4,"cua","AQUILES SERDAN",2003,757,582,69,3411,7643
8,5,"cua","ASCENSION",5145,1660,1145,119,8069,16091
8,6,"cua","BACHINIVA",1539,663,743,55,3000,5525
8,7,"cua","BALLEZA",4514,1953,222,61,6750,11975
8,8,"cua","BATOPILAS",2505,1229,126,60,3920,7856
8,9,"cua","BOCOYNA",7312,1698,1343,282,10635,19193
8,10,"cua","BUENAVENTURA",5850,1968,1252,164,9234,16167
8,11,"cua","CAMARGO",11179,5829,2892,583,20483,35859
8,12,"cua","CARICHI",1975,427,892,21,3315,6327
8,13,"cua","CASAS GRANDES",2916,760,1108,135,4919,9102
8,14,"cua","CORONADO",783,453,54,7,1297,1896
8,15,"cua","COYAME DEL SOTOL",459,300,51,8,818,1728
8,16,"cua","LA CRUZ",1105,626,158,51,1940,3172
8,17,"cua","CUAUHTEMOC",24364,10295,16361,1977,52997,110363
8,18,"cua","CUSIHUIRIACHI",1315,446,440,30,2231,5016
8,19,"cua","CHIHUAHUA",150977,110033,69591,14404,345005,599939
8,20,"cua","CHINIPAS",1737,319,237,34,2327,4869
8,21,"cua","DELICIAS",24783,15914,13404,2290,56391,101573
8,22,"cua","DR. BELISARIO DOMINGUEZ",1156,439,195,43,1833,3166
8,23,"cua","GALEANA",1187,188,531,44,1950,3542
8,24,"cua","SANTA ISABEL",1007,626,283,41,1957,3812
8,25,"cua","GOMEZ FARIAS",1949,838,763,87,3637,7304
8,26,"cua","GRAN MORELOS",1253,360,202,53,1868,3468
8,27,"cua","GUACHOCHI",10860,2712,1211,386,15169,29311
8,28,"cua","GUADALUPE",1621,435,495,46,2597,6143
8,29,"cua","GUADALUPE Y CALVO",10742,2040,650,365,13797,27520
8,30,"cua","GUAZAPARES",1940,764,223,44,2971,5974
8,31,"cua","GUERRERO",10106,2984,3205,445,16740,28458
8,32,"cua","HIDALGO DEL PARRAL",25545,12241,6596,1884,46266,79258
8,33,"cua","HUEJOTITAN",462,91,36,11,600,1392
8,34,"cua","IGNACIO ZARAGOZA",1628,349,899,88,2964,6251
8,35,"cua","JANOS",1939,483,568,65,3055,6903
8,36,"cua","JIMENEZ",10104,4572,2543,376,17595,28130
8,37,"cua","JUAREZ",195960,102942,146324,19300,464526,986784
8,38,"cua","JULIMES",1298,793,292,74,2457,4446
8,39,"cua","LOPEZ",1089,534,433,31,2087,3282
8,40,"cua","MADERA",6883,3338,1641,265,12127,22514
8,41,"cua","MAGUARICHI",589,107,68,7,771,1552
8,42,"cua","MANUEL BENAVIDES",557,207,65,9,838,1803
8,43,"cua","MATACHI",804,436,205,16,1461,2685
8,44,"cua","MATAMOROS",1327,600,312,47,2286,3877
8,45,"cua","MEOQUI",7882,4523,3863,740,17008,32619
8,46,"cua","MORELOS",1739,553,87,23,2402,4831
8,47,"cua","MORIS",1454,316,110,12,1892,3747
8,48,"cua","NAMIQUIPA",4630,2405,1547,295,8877,17920
8,49,"cua","NONOAVA",880,363,80,25,1348,2748
8,50,"cua","NUEVO CASAS GRANDES",12724,4505,6450,876,24555,46487
8,51,"cua","OCAMPO",1982,686,276,39,2983,5312
8,52,"cua","OJINAGA",6195,3826,1177,271,11469,20595
8,53,"cua","PRAXEDIS G. GUERRERO",1706,738,558,52,3054,6330
8,54,"cua","RIVA PALACIO",1000,264,238,33,1535,6763
8,55,"cua","ROSALES",3731,1761,1247,252,6991,12644
8,56,"cua","ROSARIO",697,94,132,16,939,2063
8,57,"cua","SAN FRANCISCO DE BORJA",717,519,94,17,1347,2395
8,58,"cua","SAN FRANCISCO DE CONCHOS",838,296,320,26,1480,2480
8,59,"cua","SAN FRANCISCO DEL ORO",1639,440,322,82,2483,4252
8,60,"cua","SANTA BARBARA",2655,1230,705,217,4807,8226
8,61,"cua","SATEVO",1339,924,89,17,2369,4024
8,62,"cua","SAUCILLO",6575,4422,2173,445,13615,24284
8,63,"cua","TEMOSACHIC",1683,554,371,38,2646,5144
8,64,"cua","EL TULE",662,153,73,12,900,2129
8,65,"cua","URIQUE",3817,1097,379,103,5396,12429
8,66,"cua","URUACHI",1909,557,142,19,2627,5179
8,67,"cua","VALLE DE ZARAGOZA",1707,492,172,22,2393,4390
9,2,"df","AZCAPOTZALCO",69819,48404,132616,4888,255727,373341
9,3,"df","COYOACAN",89399,78639,206672,6046,380756,546176
9,4,"df","CUAJIMALPA DE MORELOS",31506,21579,36898,1812,91795,139926
9,5,"df","GUSTAVO A. MADERO",180979,107009,367512,13025,668525,1018621
9,6,"df","IZTACALCO",61405,34856,126109,4545,226915,341098
9,7,"df","IZTAPALAPA",217695,111076,528451,16596,873818,1384725
9,8,"df","LA MAGDALENA CONTRERAS",33461,20398,67997,2285,124141,185306
9,9,"df","MILPA ALTA",16909,4592,33607,898,56006,90192
9,10,"df","ALVARO OBREGON",94091,83059,195678,7008,379836,569112
9,11,"df","TLAHUAC",43700,16085,98472,3202,161459,256627
9,12,"df","TLALPAN",79763,61299,187194,5541,333797,502800
9,13,"df","XOCHIMILCO",50197,26204,119233,3572,199206,310534
9,14,"df","BENITO JUAREZ",61916,77279,95587,3594,238376,338593
9,15,"df","CUAUHTEMOC",88026,53712,148985,5506,296229,460002
9,16,"df","MIGUEL HIDALGO",60900,56813,87015,3418,208146,306775
9,17,"df","VENUSTIANO CARRANZA",78082,40487,133271,5259,257099,392915
10,1,"dgo","CANATLAN",8241,3527,2603,286,14657,23053
10,2,"dgo","CANELAS",1104,473,88,1,1666,2857
10,3,"dgo","CONETO DE COMONFORT",1203,420,401,6,2030,3421
10,4,"dgo","CUENCAME",7607,3375,2713,265,13960,23742
10,5,"dgo","DURANGO",97904,73703,64171,6914,242692,414225
10,6,"dgo","SIMON BOLIVAR",2962,1404,531,32,4929,7876
10,7,"dgo","GOMEZ PALACIO",57022,37517,29304,3049,126892,221461
10,8,"dgo","GUADALUPE VICTORIA",8803,3918,3654,314,16689,26667
10,9,"dgo","GUANACEVI",2795,1591,315,48,4749,7741
10,10,"dgo","HIDALGO",1368,605,250,27,2250,3445
10,11,"dgo","INDE",1528,1165,167,23,2883,4679
10,12,"dgo","LERDO",24711,17127,12408,1207,55453,94872
10,13,"dgo","MAPIMI",6003,2675,1559,191,10428,16528
10,14,"dgo","MEZQUITAL",7404,3545,1903,140,12992,22129
10,15,"dgo","NAZAS",3008,2310,838,39,6195,8988
10,16,"dgo","NOMBRE DE DIOS",4196,2090,1639,230,8155,13838
10,17,"dgo","NUEVO IDEAL",4848,2668,1337,153,9006,19051
10,18,"dgo","OCAMPO",2846,1222,529,82,4679,7423
10,19,"dgo","EL ORO",3481,1388,628,85,5582,9619
10,20,"dgo","OTAEZ",1611,357,189,16,2173,3427
10,21,"dgo","PANUCO DE CORONADO",3280,1773,970,80,6103,10193
10,22,"dgo","PE�ON BLANCO",2643,1291,1115,48,5097,8077
10,23,"dgo","POANAS",5566,3261,2068,323,11218,18020
10,24,"dgo","PUEBLO NUEVO",9198,4643,1877,179,15897,28066
10,25,"dgo","RODEO",3332,1581,967,92,5972,9350
10,26,"dgo","SAN BERNARDO",1314,248,163,30,1755,3041
10,27,"dgo","SAN DIMAS",4277,1554,1060,68,6959,12737
10,28,"dgo","SAN JUAN DE GUADALUPE",1522,1094,190,20,2826,4472
10,29,"dgo","SAN JUAN DEL RIO",3201,2412,327,83,6023,9475
10,30,"dgo","SAN LUIS DEL CORDERO",632,300,134,9,1075,1799
10,31,"dgo","SAN PEDRO DEL GALLO",606,211,122,7,946,1459
10,32,"dgo","SANTA CLARA",2032,913,366,53,3364,5341
10,33,"dgo","SANTIAGO PAPASQUIARO",11844,5142,2038,532,19556,35029
10,34,"dgo","SUCHIL",1369,739,638,163,2909,5149
10,35,"dgo","TAMAZULA",6761,733,257,22,7773,13976
10,36,"dgo","TEPEHUANES",2653,1662,359,80,4754,9247
10,37,"dgo","TLAHUALILO",4764,2312,1985,280,9341,14371
10,38,"dgo","TOPIA",2258,363,137,11,2769,4790
10,39,"dgo","VICENTE GUERRERO",4627,2677,1632,220,9156,15496
11,1,"gua","ABASOLO",16884,15472,4567,887,37810,61956
11,2,"gua","ACAMBARO",15166,16640,12974,1330,46110,93572
11,3,"gua","SAN MIGUEL DE ALLENDE",25354,24287,8283,2087,60011,108504
11,4,"gua","APASEO EL ALTO",9272,10055,6706,570,26603,46765
11,5,"gua","APASEO EL GRANDE",14918,13116,4282,832,33148,58524
11,6,"gua","ATARJEA",1879,1207,133,16,3235,3976
11,7,"gua","CELAYA",73901,86315,29111,5890,195217,326809
11,8,"gua","MANUEL DOBLADO",9791,4831,1763,315,16700,29608
11,9,"gua","COMONFORT",9764,15119,3480,865,29228,53285
11,10,"gua","CORONEO",2766,2011,866,94,5737,9075
11,11,"gua","CORTAZAR",14820,17742,5084,1584,39230,67191
11,12,"gua","CUERAMARO",5779,4107,2810,214,12910,21348
11,13,"gua","DOCTOR MORA",5031,3358,1441,715,10545,15533
11,14,"gua","DOLORES HIDALGO CUNA DE LA INDEPENDENCIA NACIONAL",23106,24609,5400,1778,54893,99801
11,15,"gua","GUANAJUATO",31554,22078,13425,2322,69379,120093
11,16,"gua","HUANIMARO",4438,2930,2293,129,9790,15871
11,17,"gua","IRAPUATO",93452,84225,23750,5050,206477,357090
11,18,"gua","JARAL DEL PROGRESO",7660,6464,1930,834,16888,26918
11,19,"gua","JERECUARO",9017,6274,3753,371,19415,41266
11,20,"gua","LEON",239978,269163,51145,13988,574274,951487
11,21,"gua","MOROLEON",7953,10423,4124,810,23310,40477
11,22,"gua","OCAMPO",4122,4770,1215,79,10186,15968
11,23,"gua","PENJAMO",32004,23570,7189,1045,63808,117061
11,24,"gua","PUEBLO NUEVO",2493,2474,1006,1056,7029,10127
11,25,"gua","PURISIMA DEL RINCON",11963,13730,1075,398,27166,44313
11,26,"gua","ROMITA",10587,6191,6034,473,23285,40411
11,27,"gua","SALAMANCA",45959,47441,17698,3486,114584,192265
11,28,"gua","SALVATIERRA",15095,19601,8613,1018,44327,81323
11,29,"gua","SAN DIEGO DE LA UNION",6065,7134,1233,380,14812,25719
11,30,"gua","SAN FELIPE",20018,13803,4329,971,39121,71695
11,31,"gua","SAN FRANCISCO DEL RINCON",22230,22945,3228,803,49206,81347
11,32,"gua","SAN JOSE ITURBIDE",12256,11436,4851,1114,29657,48304
11,33,"gua","SAN LUIS DE LA PAZ",17117,14842,6783,2427,41169,76150
11,34,"gua","SANTA CATARINA",1211,1374,205,18,2808,3867
11,35,"gua","SANTA CRUZ DE JUVENTINO ROSAS",11603,16769,4442,1071,33885,54768
11,36,"gua","SANTIAGO MARAVATIO",1849,2100,359,31,4339,6427
11,37,"gua","SILAO",30847,24264,6415,1436,62962,116294
11,38,"gua","TARANDACUAO",2746,2240,686,101,5773,10000
11,39,"gua","TARIMORO",6429,7009,2033,1376,16847,30266
11,40,"gua","TIERRA BLANCA",2847,3416,1830,134,8227,11214
11,41,"gua","URIANGATO",11164,10376,3237,547,25324,44916
11,42,"gua","VALLE DE SANTIAGO",14343,23017,19254,2245,58859,108040
11,43,"gua","VICTORIA",4317,3592,1116,187,9212,13818
11,44,"gua","VILLAGRAN",9226,11788,3542,1406,25962,38918
11,45,"gua","XICHU",2944,2635,273,20,5872,7941
11,46,"gua","YURIRIA",13343,12080,5228,801,31452,59937
12,1,"gue","ACAPULCO DE JUAREZ",100557,37551,142805,5060,285973,577887
12,2,"gue","AHUACUOTZINGO",3767,737,5741,37,10282,15592
12,3,"gue","AJUCHITLAN DEL PROGRESO",7475,695,9591,103,17864,28068
12,4,"gue","ALCOZAUCA DE GUERRERO",2889,75,3329,13,6306,11580
12,5,"gue","ALPOYECA",1117,224,1639,20,3000,4856
12,6,"gue","APAXTLA",1857,238,2990,92,5177,8904
12,7,"gue","ARCELIA",7222,563,7486,58,15329,23982
12,8,"gue","ATENANGO DEL RIO",2006,229,1663,38,3936,6120
12,9,"gue","ATLAMAJALCINGO DEL MONTE",837,147,1312,30,2326,3480
12,10,"gue","ATLIXTAC",3181,2369,3720,313,9583,13817
12,11,"gue","ATOYAC DE ALVAREZ",11417,1232,12224,292,25165,42108
12,12,"gue","AYUTLA DE LOS LIBRES",7426,5140,9626,170,22362,36296
12,13,"gue","AZOYU",2805,446,3790,79,7120,10129
12,80,"gue","MARQUELIA",1624,714,3362,55,5755,9008
12,81,"gue","JUCHITAN",1066,864,1788,21,3739,5531
12,14,"gue","BENITO JUAREZ",3660,431,4020,97,8208,12128
12,15,"gue","BUENAVISTA DE CUELLAR",2983,1146,1910,103,6142,9563
12,16,"gue","COAHUAYUTLA DE JOSE MARIA IZAZAGA",2450,256,3286,6,5998,9055
12,17,"gue","COCULA",2911,755,2648,443,6757,11882
12,18,"gue","COPALA",2126,969,3075,28,6198,9285
12,19,"gue","COPALILLO",2026,339,3994,47,6406,9193
12,20,"gue","COPANATOYAC",3114,186,3720,27,7047,10947
12,21,"gue","COYUCA DE BENITEZ",12213,5199,12209,459,30080,49622
12,22,"gue","COYUCA DE CATALAN",9549,1344,8756,76,19725,33698
12,23,"gue","CUAJINICUILAPA",3213,2116,4778,71,10178,17907
12,24,"gue","CUALAC",1272,408,1319,330,3329,4646
12,25,"gue","CUAUTEPEC",2264,290,4501,21,7076,10116
12,26,"gue","CUETZALA DEL PROGRESO",1935,192,2136,80,4343,7103
12,27,"gue","CUTZAMALA DE PINZON",4277,528,5560,33,10398,19403
12,28,"gue","CHILAPA DE ALVAREZ",19957,3326,20052,564,43899,73238
12,77,"gue","JOSE JOAQUIN DE HERRERA",1351,1392,3037,29,5809,8128
12,29,"gue","CHILPANCINGO DE LOS BRAVO",37052,7590,46985,1589,93216,165887
12,30,"gue","EDUARDO NERI",8293,2048,8885,213,19439,30430
12,31,"gue","FLORENCIO VILLARREAL",3042,1102,4770,90,9004,14387
12,32,"gue","GENERAL CANUTO A. NERI",1478,99,1620,56,3253,5024
12,33,"gue","GENERAL HELIODORO CASTILLO",6388,1753,4712,51,12904,20375
12,34,"gue","HUAMUXTITLAN",2898,1264,3167,55,7384,10911
12,35,"gue","HUITZUCO DE LOS FIGUEROA",7834,1604,5078,237,14753,28602
12,36,"gue","IGUALA DE LA INDEPENDENCIA",21552,5994,26099,1369,55014,103079
12,37,"gue","IGUALAPA",1441,556,2967,16,4980,6947
12,38,"gue","IXCATEOPAN DE CUAUHTEMOC",1847,334,1848,27,4056,5631
12,39,"gue","ZIHUATANEJO DE AZUETA",19001,5409,26321,808,51539,89896
12,40,"gue","JUAN R. ESCUDERO",4291,1932,3894,161,10278,17093
12,41,"gue","LEONARDO BRAVO",5216,1002,3691,84,9993,15415
12,42,"gue","MALINALTEPEC",2174,462,7380,49,10065,15198
12,78,"gue","ILIATENCO",1338,71,2502,275,4186,5766
12,43,"gue","MARTIR DE CUILAPAN",2207,761,3337,619,6924,10979
12,44,"gue","METLATONOC",1443,813,4303,31,6590,10073
12,79,"gue","COCHOAPA EL GRANDE",3871,144,3814,37,7866,11280
12,45,"gue","MOCHITLAN",2559,426,2553,166,5704,8063
12,46,"gue","OLINALA",6233,393,4937,32,11595,15864
12,47,"gue","OMETEPEC",7869,3434,12842,246,24391,38406
12,48,"gue","PEDRO ASCENCIO ALQUISIRAS",1705,166,1561,306,3738,5102
12,49,"gue","PETATLAN",8627,1040,8180,218,18065,31918
12,50,"gue","PILCAYA",2794,1236,1805,78,5913,8187
12,51,"gue","PUNGARABATO",7915,971,8128,149,17163,28985
12,52,"gue","QUECHULTENANGO",6095,1573,6009,92,13769,21203
12,53,"gue","SAN LUIS ACATLAN",4195,848,8944,72,14059,22529
12,54,"gue","SAN MARCOS",6103,5193,9983,194,21473,33664
12,55,"gue","SAN MIGUEL TOTOLAPAN",4964,1069,4787,27,10847,17184
12,56,"gue","TAXCO DE ALARCON",22281,9385,16060,766,48492,77424
12,57,"gue","TECOANAPA",7540,3826,7341,176,18883,27832
12,58,"gue","TECPAN DE GALEANA",10007,1341,13917,1013,26278,44912
12,59,"gue","TELOLOAPAN",6794,1608,12352,252,21006,40104
12,60,"gue","TEPECOACUILCO DE TRUJANO",4898,3049,5503,198,13648,24323
12,61,"gue","TETIPAC",3592,1238,1465,88,6383,9196
12,62,"gue","TIXTLA DE GUERRERO",5484,974,8430,338,15226,26900
12,63,"gue","TLACOACHISTLAHUACA",2940,1595,2725,133,7393,12326
12,64,"gue","TLACOAPA",1808,53,1932,13,3806,5280
12,65,"gue","TLALCHAPA",3005,336,3245,14,6600,10046
12,66,"gue","TLALIXTAQUILLA DE MALDONADO",1275,196,1549,24,3044,4871
12,67,"gue","TLAPA DE COMONFORT",9001,3418,17819,327,30565,50588
12,68,"gue","TLAPEHUALA",5518,513,5380,149,11560,17060
12,69,"gue","LA UNION DE ISIDORO MONTES DE OCA",6676,501,7057,100,14334,21206
12,70,"gue","XALPATLAHUAC",1281,202,3813,182,5478,8494
12,71,"gue","XOCHIHUEHUETLAN",920,530,2054,18,3522,5807
12,72,"gue","XOCHISTLAHUACA",4989,622,6473,24,12108,16348
12,73,"gue","ZAPOTITLAN TABLAS",1858,789,1493,28,4168,5742
12,76,"gue","ACATEPEC",2714,2329,6616,36,11695,14646
12,74,"gue","ZIRANDARO",3910,751,3991,41,8693,14857
12,75,"gue","ZITLALA",3771,1113,4790,151,9825,13833
13,1,"hgo","ACATLAN",4098,1645,1911,291,7945,15362
13,2,"hgo","ACAXOCHITLAN",6714,3673,4081,356,14824,26551
13,3,"hgo","ACTOPAN",11068,3322,9534,1243,25167,40185
13,4,"hgo","AGUA BLANCA DE ITURBIDE",2327,1031,941,78,4377,6341
13,5,"hgo","AJACUBA",3347,950,2895,331,7523,12415
13,6,"hgo","ALFAJAYUCAN",3771,1399,3354,255,8779,14480
13,7,"hgo","ALMOLOYA",2916,993,1047,246,5202,7931
13,8,"hgo","APAN",7755,3615,6370,988,18728,30055
13,9,"hgo","ATITALAQUIA",5366,2059,4197,386,12008,17695
13,10,"hgo","ATLAPEXCO",4688,1043,3496,247,9474,13112
13,11,"hgo","ATOTONILCO EL GRANDE",5375,2805,3054,1197,12431,22257
13,12,"hgo","ATOTONILCO DE TULA",6455,1691,6420,420,14986,21482
13,13,"hgo","CALNALI",3729,2193,2149,187,8258,11494
13,14,"hgo","CARDONAL",3411,857,3228,560,8056,13833
13,15,"hgo","CUAUTEPEC DE HINOJOSA",9837,4709,6851,1144,22541,37138
13,16,"hgo","CHAPANTONGO",3407,929,1468,174,5978,8902
13,17,"hgo","CHAPULHUACAN",5296,1203,2945,189,9633,15013
13,18,"hgo","CHILCUAUTLA",3859,886,3096,264,8105,12367
13,19,"hgo","EL ARENAL",4242,1153,2321,312,8028,12089
13,20,"hgo","ELOXOCHITLAN",787,82,746,51,1666,2549
13,21,"hgo","EMILIANO ZAPATA",2935,867,2291,290,6383,9845
13,22,"hgo","EPAZOYUCAN",2789,1564,1761,307,6421,10022
13,23,"hgo","FRANCISCO I. MADERO",6763,1275,7712,1323,17073,24914
13,24,"hgo","HUASCA DE OCAMPO",3177,1663,2864,409,8113,12861
13,25,"hgo","HUAUTLA",4195,1060,3778,749,9782,15466
13,26,"hgo","HUAZALINGO",1900,431,3580,90,6001,8023
13,27,"hgo","HUEHUETLA",4888,1826,2966,920,10600,15297
13,28,"hgo","HUEJUTLA DE REYES",23192,7606,17251,2314,50363,78748
13,29,"hgo","HUICHAPAN",11236,3515,4238,700,19689,30872
13,30,"hgo","IXMIQUILPAN",14794,7140,16564,1606,40104,64955
13,31,"hgo","JACALA DE LEDEZMA",3417,637,1573,137,5764,9424
13,32,"hgo","JALTOCAN",2656,504,2048,133,5341,7583
13,33,"hgo","JUAREZ HIDALGO",977,81,652,57,1767,2592
13,34,"hgo","LA MISION",2164,277,2191,77,4709,7546
13,35,"hgo","LOLOTLA",2334,1266,890,126,4616,6671
13,36,"hgo","METEPEC",2756,957,1237,270,5220,8209
13,37,"hgo","METZTITLAN",4906,1030,3082,282,9300,16029
13,38,"hgo","MINERAL DEL CHICO",1867,513,1397,130,3907,5991
13,39,"hgo","MINERAL DEL MONTE",3187,1067,2024,260,6538,10670
13,40,"hgo","MINERAL DE LA REFORMA",18896,11977,18419,2488,51780,80797
13,47,"hgo","PACHUCA DE SOTO",48063,30531,48479,6099,133172,198678
13,41,"hgo","MIXQUIAHUALA DE JUAREZ",7877,3095,7179,892,19043,29343
13,42,"hgo","MOLANGO DE ESCAMILLA",2261,649,1766,342,5018,7690
13,43,"hgo","NICOLAS FLORES",2264,292,798,43,3397,5073
13,44,"hgo","NOPALA DE VILLAGRAN",4439,1278,1450,129,7296,10663
13,45,"hgo","OMITLAN DE JUAREZ",2043,1135,1025,139,4342,6528
13,46,"hgo","PACULA",1271,1312,113,27,2723,4249
13,48,"hgo","PISAFLORES",3742,3344,497,155,7738,11309
13,49,"hgo","PROGRESO DE OBREGON",4769,1635,4724,427,11555,16817
13,50,"hgo","SAN AGUSTIN METZQUITITLAN",2572,649,1338,287,4846,7346
13,51,"hgo","SAN AGUSTIN TLAXIACA",5988,1995,4520,481,12984,20660
13,52,"hgo","SAN BARTOLO TUTOTEPEC",3529,874,3236,348,7987,11575
13,53,"hgo","SAN FELIPE ORIZATLAN",7994,4628,3855,606,17083,25990
13,54,"hgo","SAN SALVADOR",5960,1223,7320,666,15169,23133
13,55,"hgo","SANTIAGO DE ANAYA",3479,778,2441,222,6920,11676
13,56,"hgo","SANTIAGO TULANTEPEC DE LUGO GUERRERO",5459,2504,4449,566,12978,21848
13,57,"hgo","SINGUILUCAN",3915,865,1715,237,6732,10978
13,58,"hgo","TASQUILLO",3336,821,3325,293,7775,13996
13,59,"hgo","TECOZAUTLA",6829,3187,4519,418,14953,23984
13,60,"hgo","TENANGO DE DORIA",3407,1706,2204,254,7571,11599
13,61,"hgo","TEPEAPULCO",9822,4957,10074,1341,26194,39950
13,62,"hgo","TEPEHUACAN DE GUERRERO",6951,1701,2892,342,11886,16714
13,63,"hgo","TEPEJI DEL RIO DE OCAMPO",14836,5076,12417,1104,33433,54644
13,64,"hgo","TEPETITLAN",2121,992,1647,160,4920,7327
13,65,"hgo","TETEPANGO",1729,231,3224,197,5381,7682
13,66,"hgo","TEZONTEPEC DE ALDAMA",8551,3928,8521,593,21593,31924
13,67,"hgo","TIANGUISTENGO",2769,1303,1184,439,5695,9898
13,68,"hgo","TIZAYUCA",16373,7277,12846,1481,37977,62914
13,69,"hgo","TLAHUELILPAN",3494,813,3318,271,7896,11635
13,70,"hgo","TLAHUILTEPA",2936,602,1145,188,4871,7359
13,71,"hgo","TLANALAPA",2474,687,2286,213,5660,7990
13,72,"hgo","TLANCHINOL",6100,4702,3744,405,14951,22044
13,73,"hgo","TLAXCOAPAN",5109,1458,5042,429,12038,18516
13,74,"hgo","TOLCAYUCA",2891,1543,1575,219,6228,9369
13,75,"hgo","TULA DE ALLENDE",20111,7599,20296,1566,49572,74880
13,76,"hgo","TULANCINGO DE BRAVO",25636,14110,24286,2942,66974,108637
13,77,"hgo","VILLA DE TEZONTEPEC",2590,850,1305,280,5025,7673
13,78,"hgo","XOCHIATIPAN",4315,2138,2043,97,8593,11043
13,79,"hgo","XOCHICOATLAN",1581,701,1219,285,3786,5527
13,80,"hgo","YAHUALICA",4901,1402,4880,229,11412,14616
13,81,"hgo","ZACUALTIPAN DE ANGELES",5886,2211,3618,910,12625,22937
13,82,"hgo","ZAPOTLAN DE JUAREZ",3832,1897,2198,292,8219,12729
13,83,"hgo","ZEMPOALA",7409,2455,5081,1417,16362,25393
13,84,"hgo","ZIMAPAN",8117,2378,5630,587,16712,29336
14,1,"jal","ACATIC",4375,2975,1446,312,9108,14879
14,2,"jal","ACATLAN DE JUAREZ",5237,2685,1980,636,10538,16050
14,3,"jal","AHUALULCO DE MERCADO",5803,2771,3167,321,12062,16468
14,4,"jal","AMACUECA",1330,889,446,88,2753,4187
14,5,"jal","AMATITAN",3420,1490,2048,349,7307,10250
14,6,"jal","AMECA",11014,9138,6650,1166,27968,45569
14,7,"jal","SAN JUANITO DE ESCOBEDO",2026,1166,1333,80,4605,7183
14,8,"jal","ARANDAS",18208,9651,2946,475,31280,47084
14,125,"jal","SAN IGNACIO CERRO GORDO",4193,2892,566,182,7833,13622
14,9,"jal","EL ARENAL",4318,2680,1337,208,8543,12548
14,10,"jal","ATEMAJAC DE BRIZUELA",1222,1023,753,85,3083,4075
14,11,"jal","ATENGO",1475,1192,475,20,3162,4289
14,12,"jal","ATENGUILLO",1229,777,294,56,2356,3354
14,13,"jal","ATOTONILCO EL ALTO",14143,9851,2894,481,27369,42816
14,14,"jal","ATOYAC",1977,1831,453,34,4295,6578
14,15,"jal","AUTLAN DE NAVARRO",11774,8378,6949,747,27848,44743
14,16,"jal","AYOTLAN",7232,4858,4618,182,16890,26988
14,17,"jal","AYUTLA",2861,3606,390,45,6902,10268
14,18,"jal","LA BARCA",12225,8790,6281,479,27775,50058
14,19,"jal","BOLA�OS",2041,777,1024,40,3882,4956
14,20,"jal","CABO CORRIENTES",2532,1438,2163,30,6163,8415
14,21,"jal","CASIMIRO CASTILLO",4055,2771,2160,711,9697,15419
14,22,"jal","CIHUATLAN",6567,5411,4757,352,17087,26031
14,23,"jal","ZAPOTLAN EL GRANDE",20440,13035,13474,1655,48604,75824
14,24,"jal","SAN GABRIEL",3202,2530,1899,57,7688,11283
14,25,"jal","COCULA",5076,4593,4295,265,14229,21658
14,26,"jal","COLOTLAN",5157,2735,1285,125,9302,13899
14,27,"jal","CONCEPCION DE BUENOS AIRES",1627,918,636,25,3206,4501
14,28,"jal","CUAUTITLAN DE GARCIA BARRAGAN",4733,4244,627,49,9653,11923
14,29,"jal","CUAUTLA",631,641,61,15,1348,2087
14,30,"jal","CUQUIO",3569,2175,2924,148,8816,13693
14,31,"jal","CHAPALA",9425,8373,4913,559,23270,33861
14,32,"jal","CHIMALTITAN",900,748,43,7,1698,2445
14,33,"jal","CHIQUILISTLAN",975,759,724,230,2688,3986
14,34,"jal","DEGOLLADO",5866,3760,822,135,10583,17178
14,35,"jal","EJUTLA",560,516,109,13,1198,1818
14,36,"jal","ENCARNACION DE DIAZ",9032,11476,1445,366,22319,35167
14,37,"jal","ETZATLAN",4282,2941,2211,444,9878,13774
14,38,"jal","GOMEZ FARIAS",2794,2079,1765,100,6738,10723
14,39,"jal","EL GRULLO",3805,5040,1886,259,10990,18191
14,40,"jal","GUACHINANGO",1132,904,310,26,2372,3533
14,41,"jal","GUADALAJARA",316339,267674,217000,23748,824761,1243951
14,42,"jal","HOSTOTIPAQUILLO",2703,868,727,82,4380,6440
14,43,"jal","HUEJUCAR",1368,1136,552,280,3336,5075
14,44,"jal","HUEJUQUILLA EL ALTO",2339,1729,217,22,4307,6695
14,45,"jal","LA HUERTA",5554,3024,2929,356,11863,17811
14,46,"jal","IXTLAHUACAN DE LOS MEMBRILLOS",5919,2981,4422,678,14000,22226
14,47,"jal","IXTLAHUACAN DEL RIO",4487,2491,1592,364,8934,15169
14,48,"jal","JALOSTOTITLAN",5742,6281,828,215,13066,21951
14,49,"jal","JAMAY",3938,4316,2135,611,11000,16887
14,50,"jal","JESUS MARIA",5036,3268,432,92,8828,15547
14,51,"jal","JILOTLAN DE LOS DOLORES",2115,1530,204,18,3867,6400
14,52,"jal","JOCOTEPEC",9455,5037,4288,450,19230,29315
14,53,"jal","JUANACATLAN",2703,2088,1605,239,6635,9493
14,54,"jal","JUCHITLAN",1817,1354,239,35,3445,4797
14,55,"jal","LAGOS DE MORENO",29638,26283,7304,1451,64676,107133
14,56,"jal","EL LIMON",1236,1047,976,118,3377,5332
14,57,"jal","MAGDALENA",5455,2805,1013,103,9376,14966
14,58,"jal","SANTA MARIA DEL ORO",721,576,52,0,1349,2147
14,59,"jal","LA MANZANILLA DE LA PAZ",818,732,775,19,2344,3047
14,60,"jal","MASCOTA",3256,2074,1444,192,6966,10310
14,61,"jal","MAZAMITLA",3772,1710,1607,91,7180,9645
14,62,"jal","MEXTICACAN",1343,1381,243,92,3059,4905
14,63,"jal","MEZQUITIC",3801,2398,453,968,7620,11039
14,64,"jal","MIXTLAN",929,509,469,263,2170,3049
14,65,"jal","OCOTLAN",16052,14262,11096,1045,42455,68283
14,66,"jal","OJUELOS DE JALISCO",5458,2934,3628,157,12177,18006
14,67,"jal","PIHUAMO",2475,1564,1628,149,5816,9350
14,68,"jal","PONCITLAN",7678,4272,6071,1421,19442,31389
14,69,"jal","PUERTO VALLARTA",33791,27456,40607,2172,104026,186578
14,70,"jal","VILLA PURIFICACION",2634,1945,1137,379,6095,9306
14,71,"jal","QUITUPAN",2493,1295,555,33,4376,8583
14,72,"jal","EL SALTO",24320,16389,13780,1618,56107,92404
14,73,"jal","SAN CRISTOBAL DE LA BARRANCA",1083,680,135,14,1912,3039
14,74,"jal","SAN DIEGO DE ALEJANDRIA",2069,1270,158,53,3550,4954
14,75,"jal","SAN JUAN DE LOS LAGOS",14941,12751,1926,515,30133,44712
14,76,"jal","SAN JULIAN",5138,2566,459,130,8293,12415
14,77,"jal","SAN MARCOS",1011,515,496,159,2181,2875
14,78,"jal","SAN MARTIN DE BOLA�OS",1053,657,121,14,1845,2614
14,79,"jal","SAN MARTIN HIDALGO",5229,3926,4437,316,13908,22280
14,80,"jal","SAN MIGUEL EL ALTO",6296,6058,1135,305,13794,22207
14,81,"jal","SAN SEBASTIAN DEL OESTE",1675,449,1032,70,3226,4581
14,82,"jal","SANTA MARIA DE LOS ANGELES",1094,881,156,19,2150,3169
14,83,"jal","SAYULA",5625,4398,5188,674,15885,24060
14,84,"jal","TALA",12763,7781,6635,874,28053,46510
14,85,"jal","TALPA DE ALLENDE",4240,2458,644,492,7834,10189
14,86,"jal","TAMAZULA DE GORDIANO",9110,5554,4856,249,19769,33711
14,87,"jal","TAPALPA",3360,2814,1937,1232,9343,11592
14,88,"jal","TECALITLAN",3267,2483,1898,81,7729,12723
14,89,"jal","TECOLOTLAN",3566,3045,1736,230,8577,12616
14,90,"jal","TECHALUTA DE MONTENEGRO",699,796,555,25,2075,2842
14,91,"jal","TENAMAXTLAN",1856,1586,478,70,3990,5842
14,92,"jal","TEOCALTICHE",8933,5575,1982,361,16851,29591
14,93,"jal","TEOCUITATLAN DE CORONA",3080,2559,473,116,6228,9349
14,94,"jal","TEPATITLAN DE MORELOS",24028,26108,7293,1794,59223,101293
14,95,"jal","TEQUILA",6990,5579,4655,256,17480,27555
14,96,"jal","TEUCHITLAN",2027,1763,1384,165,5339,7334
14,97,"jal","TIZAPAN EL ALTO",4015,2161,1966,414,8556,15572
14,98,"jal","TLAJOMULCO DE ZU�IGA",44263,40290,37758,3889,126200,197359
14,99,"jal","TLAQUEPAQUE",106913,75803,58025,7652,248393,406228
14,100,"jal","TOLIMAN",2284,1089,1183,56,4612,7114
14,101,"jal","TOMATLAN",6036,3239,5135,412,14822,24268
14,102,"jal","TONALA",71930,45963,37988,5479,161360,273720
14,103,"jal","TONAYA",1700,1582,326,41,3649,5106
14,104,"jal","TONILA",1588,1672,742,20,4022,5373
14,105,"jal","TOTATICHE",1238,943,383,28,2592,3894
14,106,"jal","TOTOTLAN",4469,3770,1813,306,10358,16767
14,107,"jal","TUXCACUESCO",1124,697,550,255,2626,3526
14,108,"jal","TUXCUECA",1615,852,627,328,3422,4994
14,109,"jal","TUXPAN",6077,4260,4762,842,15941,25381
14,110,"jal","UNION DE SAN ANTONIO",4187,3256,956,71,8470,12786
14,111,"jal","UNION DE TULA",3870,2026,847,219,6962,11194
14,112,"jal","VALLE DE GUADALUPE",1682,1437,195,53,3367,5370
14,113,"jal","VALLE DE JUAREZ",1336,1409,556,14,3315,4940
14,114,"jal","VILLA CORONA",3399,3468,1620,380,8867,13678
14,115,"jal","VILLA GUERRERO",1676,1167,289,16,3148,4449
14,116,"jal","VILLA HIDALGO",3549,3484,657,795,8485,13126
14,117,"jal","CA�ADAS DE OBREGON",1113,869,163,17,2162,3655
14,118,"jal","YAHUALICA DE GONZALEZ GALLO",5340,4467,1719,174,11700,18777
14,119,"jal","ZACOALCO DE TORRES",5374,3681,3897,315,13267,21484
14,120,"jal","ZAPOPAN",205243,210729,127893,14088,557953,869720
14,121,"jal","ZAPOTILTIC",5934,3709,3904,440,13987,22410
14,122,"jal","ZAPOTITLAN DE VADILLO",1500,1080,647,25,3252,4635
14,123,"jal","ZAPOTLAN DEL REY",3769,2543,1700,123,8135,12788
14,124,"jal","ZAPOTLANEJO",13232,9182,4001,433,26848,45381
15,1,"mex","ACAMBAY",15655,6556,4068,520,26799,41299
15,2,"mex","ACOLMAN",20394,5120,16583,1126,43223,63415
15,3,"mex","ACULCO",12412,4198,3020,302,19932,28503
15,4,"mex","ALMOLOYA DE ALQUISIRAS",4149,2812,966,60,7987,10667
15,5,"mex","ALMOLOYA DE JUAREZ",37611,10560,13174,1534,62879,92940
15,6,"mex","ALMOLOYA DEL RIO",3075,689,1519,128,5411,7161
15,7,"mex","AMANALCO",4915,2294,3579,137,10925,15044
15,8,"mex","AMATEPEC",7566,1473,5339,59,14437,21303
15,9,"mex","AMECAMECA",11470,3292,9983,561,25306,35791
15,10,"mex","APAXCO",6588,2486,3368,308,12750,18600
15,11,"mex","ATENCO",7972,3118,8777,445,20312,30693
15,12,"mex","ATIZAPAN",2699,735,1346,126,4906,6803
15,13,"mex","ATIZAPAN DE ZARAGOZA",83277,62789,79494,5329,230889,366339
15,14,"mex","ATLACOMULCO",27408,6238,7278,1098,42022,63587
15,15,"mex","ATLAUTLA",4668,2068,5198,197,12131,18528
15,16,"mex","AXAPUSCO",6458,2958,2948,206,12570,15673
15,17,"mex","AYAPANGO",1848,527,1202,79,3656,4903
15,18,"mex","CALIMAYA",11298,4477,4782,509,21066,28280
15,19,"mex","CAPULHUAC",7287,1431,3649,275,12642,21014
15,20,"mex","COACALCO DE BERRIOZABAL",52757,27645,54331,4044,138777,208365
15,21,"mex","COATEPEC HARINAS",7139,5689,3076,149,16053,23135
15,22,"mex","COCOTITLAN",2886,998,3425,202,7511,9922
15,23,"mex","COYOTEPEC",8477,3292,7902,514,20185,32204
15,24,"mex","CUAUTITLAN",17377,8438,16274,1244,43333,63807
15,25,"mex","CUAUTITLAN IZCALLI",90385,56531,95682,6795,249393,370446
15,122,"mex","VALLE DE CHALCO SOLIDARIDAD",57918,14458,64180,3405,139961,236926
15,26,"mex","CHALCO",49509,14655,48669,2674,115507,189088
15,27,"mex","CHAPA DE MOTA",6691,5327,1585,143,13746,17960
15,28,"mex","CHAPULTEPEC",2379,906,1076,89,4450,5843
15,29,"mex","CHIAUTLA",6194,1743,4712,246,12895,17438
15,30,"mex","CHICOLOAPAN",29211,6852,29164,1725,66952,106168
15,31,"mex","CHICONCUAC",4113,1686,5963,168,11930,15661
15,32,"mex","CHIMALHUACAN",93473,25271,80655,5064,204463,374249
15,60,"mex","NEZAHUALCOYOTL",202835,65085,258841,12232,538993,854981
15,33,"mex","DONATO GUERRA",7585,2369,5280,196,15430,19970
15,34,"mex","ECATEPEC DE MORELOS",304951,105084,302635,19471,732141,1186569
15,35,"mex","ECATZINGO",2177,801,1027,83,4088,5857
15,36,"mex","HUEHUETOCA",18096,9092,10107,842,38137,66314
15,37,"mex","HUEYPOXTLA",10670,3324,5686,397,20077,27809
15,38,"mex","HUIXQUILUCAN",44460,28974,29457,1846,104737,156304
15,39,"mex","ISIDRO FABELA",3082,451,1482,118,5133,6900
15,40,"mex","IXTAPALUCA",74134,25124,73781,4774,177813,287271
15,41,"mex","IXTAPAN DE LA SAL",7573,3632,4596,312,16113,23117
15,42,"mex","IXTAPAN DEL ORO",1717,723,1316,28,3784,4542
15,43,"mex","IXTLAHUACA",38643,8763,11978,1518,60902,94088
15,44,"mex","XALATLACO",5606,1233,2637,238,9714,15408
15,45,"mex","JALTENCO",6048,1684,4184,301,12217,17686
15,125,"mex","TONANITLA",2082,470,1921,66,4539,6298
15,46,"mex","JILOTEPEC",22162,8006,9034,983,40185,55960
15,47,"mex","JILOTZINGO",5020,1998,2159,182,9359,12646
15,48,"mex","JIQUIPILCO",18591,3294,7248,545,29678,45074
15,49,"mex","JOCOTITLAN",18039,5693,4931,659,29322,41533
15,50,"mex","JOQUICINGO",3371,1769,1225,140,6505,8856
15,51,"mex","JUCHITEPEC",5167,2145,3279,211,10802,15367
15,52,"mex","LERMA",26701,12358,15579,1206,55844,79325
15,53,"mex","MALINALCO",5894,2582,3008,291,11775,16989
15,54,"mex","MELCHOR OCAMPO",10659,4602,9595,597,25453,38390
15,55,"mex","METEPEC",53795,30016,26532,3182,113525,157714
15,56,"mex","MEXICALTZINGO",2872,786,1588,116,5362,8049
15,57,"mex","MORELOS",8175,1498,3665,227,13565,19112
15,58,"mex","NAUCALPAN DE JUAREZ",161649,106641,130725,8826,407841,651566
15,59,"mex","NEXTLALPAN",6132,2023,3608,246,12009,17364
15,61,"mex","NICOLAS ROMERO",61440,28689,52661,4099,146889,240350
15,62,"mex","NOPALTEPEC",2911,1413,942,47,5313,6497
15,63,"mex","OCOYOACAC",13949,5100,8302,880,28231,38755
15,64,"mex","OCUILAN",6134,2153,5365,190,13842,18118
15,65,"mex","EL ORO",9408,2595,4045,329,16377,22999
15,66,"mex","OTUMBA",7801,3687,4418,295,16201,22831
15,67,"mex","OTZOLOAPAN",1511,553,1009,28,3101,3908
15,68,"mex","OTZOLOTEPEC",15186,4456,10813,811,31266,45758
15,69,"mex","OZUMBA",5554,1835,4409,201,11999,17846
15,70,"mex","PAPALOTLA",1210,517,816,51,2594,3244
15,71,"mex","LA PAZ",43999,9926,44148,2438,100511,165409
15,72,"mex","POLOTITLAN",5388,1419,846,115,7768,10343
15,73,"mex","RAYON",3149,794,1504,127,5574,7207
15,74,"mex","SAN ANTONIO LA ISLA",3849,2091,2122,154,8216,11370
15,75,"mex","SAN FELIPE DEL PROGRESO",32582,10307,6391,958,50238,75148
15,124,"mex","SAN JOSE DEL RINCON",19714,8411,3641,381,32147,53469
15,76,"mex","SAN MARTIN DE LAS PIRAMIDES",5292,3026,3702,278,12298,16659
15,77,"mex","SAN MATEO ATENCO",20544,6746,8921,1058,37269,54982
15,78,"mex","SAN SIMON DE GUERRERO",1847,225,1388,19,3479,4215
15,79,"mex","SANTO TOMAS",2439,985,1856,74,5354,6674
15,80,"mex","SOYANIQUILPAN DE JUAREZ",3713,2822,495,74,7104,8526
15,81,"mex","SULTEPEC",6961,3567,2782,71,13381,18036
15,82,"mex","TECAMAC",71283,33575,51133,3898,159889,232246
15,83,"mex","TEJUPILCO",15915,4516,11767,507,32705,50495
15,123,"mex","LUVIANOS",4848,3689,5662,94,14293,21376
15,84,"mex","TEMAMATLA",2433,1217,1748,114,5512,8277
15,85,"mex","TEMASCALAPA",7395,4281,4674,291,16641,23057
15,86,"mex","TEMASCALCINGO",17226,5624,4764,601,28215,43684
15,87,"mex","TEMASCALTEPEC",7338,4959,2553,188,15038,21287
15,88,"mex","TEMOAYA",18140,5931,9968,655,34694,53906
15,89,"mex","TENANCINGO",16538,7151,12191,1456,37336,60151
15,90,"mex","TENANGO DEL AIRE",2842,1021,1584,110,5557,7324
15,91,"mex","TENANGO DEL VALLE",15100,4749,11324,807,31980,49746
15,92,"mex","TEOLOYUCAN",14899,5131,13563,881,34474,53977
15,93,"mex","TEOTIHUACAN",12126,3896,10047,625,26694,38201
15,94,"mex","TEPETLAOXTOC",6260,1665,5358,222,13505,17972
15,95,"mex","TEPETLIXPA",3654,1044,2974,162,7834,12552
15,96,"mex","TEPOTZOTLAN",13569,7179,12370,741,33859,50792
15,97,"mex","TEQUIXQUIAC",7687,3419,4846,332,16284,22725
15,98,"mex","TEXCALTITLAN",4992,2291,2035,84,9402,11942
15,99,"mex","TEXCALYACAC",1436,227,854,77,2594,3451
15,100,"mex","TEXCOCO",35874,14836,53927,2420,107057,160368
15,101,"mex","TEZOYUCA",6275,2296,4692,297,13560,21826
15,102,"mex","TIANGUISTENCO",17101,4622,8932,907,31562,44930
15,103,"mex","TIMILPAN",5445,1627,1609,96,8777,11490
15,104,"mex","TLALMANALCO",10754,2632,8073,631,22090,33436
15,105,"mex","TLALNEPANTLA DE BAZ",132868,81843,129699,7906,352316,539260
15,106,"mex","TLATLAYA",8613,830,9361,73,18877,26237
15,107,"mex","TOLUCA",186340,91753,81976,11066,371135,545355
15,108,"mex","TONATICO",3526,1260,1977,116,6879,9283
15,109,"mex","TULTEPEC",24142,8983,24898,1574,59597,92383
15,110,"mex","TULTITLAN",83993,31505,81593,5688,202779,324127
15,111,"mex","VALLE DE BRAVO",12297,9898,7066,886,30147,44166
15,112,"mex","VILLA DE ALLENDE",10836,2908,6223,263,20230,27924
15,113,"mex","VILLA DEL CARBON",10805,4176,4546,324,19851,27617
15,114,"mex","VILLA GUERRERO",15082,4349,4801,498,24730,36091
15,115,"mex","VILLA VICTORIA",22630,11446,4289,402,38767,52260
15,116,"mex","XONACATLAN",9926,4185,9705,513,24329,34357
15,117,"mex","ZACAZONAPAN",1192,316,968,12,2488,3142
15,118,"mex","ZACUALPAN",3278,2776,933,93,7080,10084
15,119,"mex","ZINACANTEPEC",39137,16178,11155,1700,68170,100854
15,120,"mex","ZUMPAHUACAN",3830,3037,802,79,7748,10670
15,121,"mex","ZUMPANGO",31164,11969,21292,1647,66072,102329
16,1,"mic","ACUITZIO",1598,1003,1051,84,3736,7845
16,2,"mic","AGUILILLA",1942,627,1641,34,4244,13446
16,3,"mic","ALVARO OBREGON",3588,1721,2556,172,8037,15577
16,4,"mic","ANGAMACUTIRO",2842,463,2970,71,6346,12189
16,5,"mic","ANGANGUEO",2453,803,992,56,4304,7553
16,6,"mic","APATZINGAN",18991,6672,12745,681,39089,86274
16,7,"mic","APORO",800,209,529,17,1555,2546
16,8,"mic","AQUILA",5321,838,2368,34,8561,16870
16,9,"mic","ARIO",4979,4135,2277,222,11613,22790
16,10,"mic","ARTEAGA",4422,747,2901,60,8130,15965
16,11,"mic","BRISE�AS",1763,681,1100,67,3611,6703
16,12,"mic","BUENAVISTA",6497,1773,4882,132,13284,29476
16,13,"mic","CARACUARO",1932,277,1159,23,3391,7086
16,14,"mic","COAHUAYANA",1697,1221,1346,31,4295,9612
16,15,"mic","COALCOMAN DE VAZQUEZ PALLARES",2852,1660,1997,78,6587,14399
16,16,"mic","COENEO",3029,1235,3915,136,8315,18860
16,17,"mic","CONTEPEC",4850,1330,4510,198,10888,20964
16,18,"mic","COPANDARO",1360,630,1014,83,3087,7092
16,19,"mic","COTIJA",3479,2591,1764,106,7940,16565
16,20,"mic","CUITZEO",3450,2357,2979,359,9145,21167
16,21,"mic","CHARAPAN",1841,478,1763,33,4115,8629
16,22,"mic","CHARO",3282,1755,2093,146,7276,14698
16,23,"mic","CHAVINDA",2007,1131,874,64,4076,8706
16,24,"mic","CHERAN",488,97,380,10,975,1812
16,25,"mic","CHILCHOTA",5177,1383,5120,100,11780,23616
16,26,"mic","CHINICUILA",990,151,903,9,2053,3882
16,27,"mic","CHUCANDIRO",1013,195,839,39,2086,5158
16,28,"mic","CHURINTZIO",1068,301,1184,30,2583,5963
16,29,"mic","CHURUMUCO",3351,445,2324,23,6143,10628
16,30,"mic","ECUANDUREO",2544,1687,1241,79,5551,12006
16,31,"mic","EPITACIO HUERTA",2993,865,2253,95,6206,11829
16,32,"mic","ERONGARICUARO",2033,863,2587,92,5575,10607
16,33,"mic","GABRIEL ZAMORA",3137,544,3489,68,7238,15060
16,34,"mic","HIDALGO",22137,12089,7643,1052,42921,82148
16,35,"mic","LA HUACANA",7499,2246,3935,72,13752,23977
16,36,"mic","HUANDACAREO",2182,899,1469,118,4668,9569
16,37,"mic","HUANIQUEO",697,260,1944,73,2974,7504
16,38,"mic","HUETAMO",6617,1323,6593,145,14678,33745
16,39,"mic","HUIRAMBA",1158,437,1231,51,2877,5628
16,40,"mic","INDAPARAPEO",2620,952,1840,123,5535,12266
16,41,"mic","IRIMBO",2552,1188,1682,94,5516,11152
16,42,"mic","IXTLAN",2267,1143,2228,78,5716,11187
16,43,"mic","JACONA",8407,6039,5060,520,20026,44902
16,44,"mic","JIMENEZ",2150,756,1924,108,4938,11660
16,45,"mic","JIQUILPAN",6244,3316,5457,319,15336,31023
16,46,"mic","JOSE SIXTO VERDUZCO",4224,1302,5150,101,10777,21191
16,47,"mic","JUAREZ",2764,624,2210,44,5642,9774
16,48,"mic","JUNGAPEO",3477,802,2965,50,7294,13901
16,49,"mic","LAGUNILLAS",1092,457,1037,32,2618,4574
16,50,"mic","LAZARO CARDENAS",21861,8835,30314,1139,62149,126784
16,51,"mic","MADERO",2538,1474,1945,99,6056,12630
16,52,"mic","MARAVATIO",10256,5144,10453,902,26755,56496
16,53,"mic","MARCOS CASTELLANOS",2286,1942,1176,73,5477,9174
16,54,"mic","MORELIA",140488,67484,80927,8367,297266,531602
16,55,"mic","MORELOS",1343,878,636,45,2902,7841
16,56,"mic","MUGICA",6668,2215,6543,156,15582,31304
16,57,"mic","NAHUATZEN",4577,1104,5423,85,11189,18741
16,58,"mic","NOCUPETARO",2299,351,1058,18,3726,6766
16,59,"mic","NUEVO PARANGARICUTIRO",4190,1059,2109,118,7476,12463
16,60,"mic","NUEVO URECHO",1306,331,1492,37,3166,5782
16,61,"mic","NUMARAN",1948,747,1495,63,4253,8814
16,62,"mic","OCAMPO",3708,680,2855,90,7333,13366
16,63,"mic","PAJACUARAN",2928,2047,2042,118,7135,15020
16,64,"mic","PANINDICUARO",2690,667,2294,109,5760,13377
16,65,"mic","PARACUARO",3080,877,3441,66,7464,17376
16,66,"mic","PARACHO",4378,1647,7573,179,13777,23501
16,67,"mic","PATZCUARO",13199,4155,13531,945,31830,60405
16,68,"mic","PENJAMILLO",3648,945,2250,78,6921,15449
16,69,"mic","PERIBAN",4049,3259,1426,156,8890,16290
16,70,"mic","LA PIEDAD",15793,14175,8061,842,38871,72926
16,71,"mic","PUREPERO",2258,2475,1453,183,6369,12352
16,72,"mic","PURUANDIRO",8550,7053,9440,674,25717,56078
16,73,"mic","QUERENDARO",2377,1354,1345,101,5177,10619
16,74,"mic","QUIROGA",5168,2483,2815,135,10601,19187
16,75,"mic","COJUMATLAN DE REGULES",1841,706,1523,53,4123,7986
16,76,"mic","LOS REYES",10913,6123,6958,430,24424,43923
16,77,"mic","SAHUAYO",12428,10809,4564,441,28242,49036
16,78,"mic","SAN LUCAS",3003,580,3000,65,6648,14610
16,79,"mic","SANTA ANA MAYA",1850,1157,1484,122,4613,10582
16,80,"mic","SALVADOR ESCALANTE",5146,2182,8063,400,15791,30425
16,81,"mic","SENGUIO",2979,916,2290,169,6354,13759
16,82,"mic","SUSUPUATO",1608,679,1288,25,3600,6531
16,83,"mic","TACAMBARO",9407,7900,6617,704,24628,48323
16,84,"mic","TANCITARO",2967,2179,2732,137,8015,17996
16,85,"mic","TANGAMANDAPIO",3824,2242,3907,143,10116,19255
16,86,"mic","TANGANCICUARO",4453,2947,2820,252,10472,24452
16,87,"mic","TANHUATO",1492,1061,2748,96,5397,10940
16,88,"mic","TARETAN",2605,933,1925,68,5531,10398
16,89,"mic","TARIMBARO",10623,4189,6334,607,21753,47669
16,90,"mic","TEPALCATEPEC",3498,1497,2005,84,7084,17105
16,91,"mic","TINGAMBATO",2091,479,3048,101,5719,9373
16,92,"mic","TINGUINDIN",2233,2004,1639,104,5980,10473
16,93,"mic","TIQUICHEO DE NICOLAS ROMERO",2492,457,1827,23,4799,10125
16,94,"mic","TLALPUJAHUA",6071,1283,2520,282,10156,18822
16,95,"mic","TLAZAZALCA",1267,467,1516,40,3290,7494
16,96,"mic","TOCUMBO",2376,1144,1338,84,4942,9275
16,97,"mic","TUMBISCATIO",1890,158,1118,15,3181,6327
16,98,"mic","TURICATO",4625,1171,4811,145,10752,22974
16,99,"mic","TUXPAN",4451,1523,3462,162,9598,18100
16,100,"mic","TUZANTLA",3553,787,2890,22,7252,13019
16,101,"mic","TZINTZUNTZAN",2008,490,2201,92,4791,9947
16,102,"mic","TZITZIO",1962,890,755,31,3638,7531
16,103,"mic","URUAPAN",49893,23171,33551,3249,109864,211737
16,104,"mic","VENUSTIANO CARRANZA",3816,1589,3284,132,8821,18077
16,105,"mic","VILLAMAR",3224,1356,1879,148,6607,15727
16,106,"mic","VISTA HERMOSA",3359,1186,2183,82,6810,13943
16,107,"mic","YURECUARO",3992,2421,4271,145,10829,20428
16,108,"mic","ZACAPU",11854,6371,9403,767,28395,55304
16,109,"mic","ZAMORA",28044,19815,18235,1960,68054,133601
16,110,"mic","ZINAPARO",744,365,559,17,1685,3570
16,111,"mic","ZINAPECUARO",8454,4456,4195,395,17500,37519
16,112,"mic","ZIRACUARETIRO",2864,749,2511,84,6208,10375
16,113,"mic","ZITACUARO",26189,11532,17715,1409,56845,103035
17,1,"mor","AMACUZAC",4574,1037,3113,136,8860,13137
17,2,"mor","ATLATLAHUCAN",3163,1465,4643,188,9459,14229
17,3,"mor","AXOCHIAPAN",4548,2684,7291,276,14799,23938
17,4,"mor","AYALA",11510,6551,13993,817,32871,56199
17,5,"mor","COATLAN DEL RIO",2305,824,2284,168,5581,8190
17,6,"mor","CUAUTLA",26550,13375,37184,1938,79047,130428
17,7,"mor","CUERNAVACA",60525,47523,77484,4008,189540,292288
17,8,"mor","EMILIANO ZAPATA",13208,6433,11666,1332,32639,51633
17,9,"mor","HUITZILAC",3638,1148,3767,224,8777,12187
17,10,"mor","JANTETELCO",3259,1192,3376,159,7986,11434
17,11,"mor","JIUTEPEC",31924,19832,38108,2146,92010,148624
17,12,"mor","JOJUTLA",9829,4194,13884,444,28351,44332
17,13,"mor","JONACATEPEC",2634,1153,3792,305,7884,10943
17,14,"mor","MAZATEPEC",2580,704,2064,71,5419,7443
17,15,"mor","MIACATLAN",5114,2253,5053,153,12573,18849
17,16,"mor","OCUITUCO",3413,1276,3777,189,8655,11783
17,17,"mor","PUENTE DE IXTLA",11805,4136,11337,467,27745,44777
17,18,"mor","TEMIXCO",17301,8242,18517,1002,45062,76073
17,19,"mor","TEPALCINGO",5287,1902,5673,273,13135,18925
17,20,"mor","TEPOZTLAN",4426,3000,9469,359,17254,26005
17,21,"mor","TETECALA",1883,741,1527,96,4247,5888
17,22,"mor","TETELA DEL VOLCAN",3311,1503,3739,197,8750,12384
17,23,"mor","TLALNEPANTLA",1217,232,2085,34,3568,4526
17,24,"mor","TLALTIZAPAN",8208,3007,10719,417,22351,35410
17,25,"mor","TLAQUILTENANGO",5581,2013,7327,304,15225,24113
17,26,"mor","TLAYACAPAN",3340,1068,4304,165,8877,12210
17,27,"mor","TOTOLAPAN",1886,791,2291,211,5179,7099
17,28,"mor","XOCHITEPEC",10188,5579,10453,523,26743,42560
17,29,"mor","YAUTEPEC",15758,7441,19307,1108,43614,69821
17,30,"mor","YECAPIXTLA",7670,2725,8588,598,19581,31220
17,31,"mor","ZACATEPEC",6400,1859,10032,258,18549,28397
17,32,"mor","ZACUALPAN",1641,578,2744,179,5142,6629
17,33,"mor","TEMOAC",1970,887,4242,315,7414,9691
18,1,"nay","ACAPONETA",8660,2654,4465,228,16007,25243
18,2,"nay","AHUACATLAN",3921,1814,1509,94,7338,11715
18,3,"nay","AMATLAN DE CA�AS",3153,2027,860,46,6086,8990
18,4,"nay","BAHIA DE BANDERAS",17845,7824,13039,576,39284,71245
18,5,"nay","COMPOSTELA",14930,6393,9733,429,31485,52877
18,6,"nay","HUAJICORI",2679,293,1477,20,4469,6946
18,7,"nay","IXTLAN DEL RIO",7041,3067,2726,235,13069,19580
18,8,"nay","JALA",4380,2562,1153,97,8192,12120
18,9,"nay","DEL NAYAR",7702,2373,1036,83,11194,20730
18,10,"nay","ROSAMORADA",8675,3347,3823,221,16066,25053
18,11,"nay","RUIZ",4893,3650,2166,89,10798,16032
18,12,"nay","SAN BLAS",9055,3316,4428,220,17019,28304
18,13,"nay","SAN PEDRO LAGUNILLAS",2107,1210,535,64,3916,6404
18,14,"nay","SANTA MARIA DEL ORO",6013,1733,1930,263,9939,16498
18,15,"nay","SANTIAGO IXCUINTLA",19911,4854,16134,577,41476,68792
18,16,"nay","TECUALA",10057,2100,6029,175,18361,29245
18,17,"nay","TEPIC",71558,26203,64227,4844,166832,267826
18,18,"nay","TUXPAN",6898,2432,4646,178,14154,22476
18,19,"nay","XALISCO",9741,3907,5732,456,19836,32421
18,20,"nay","LA YESCA",2461,1209,230,19,3919,7195
19,1,"nl","ABASOLO",549,486,611,70,1716,2234
19,2,"nl","AGUALEGUAS",1275,856,520,8,2659,3864
19,3,"nl","LOS ALDAMAS",692,504,41,4,1241,2321
19,4,"nl","ALLENDE",6160,3906,2912,289,13267,23773
19,5,"nl","ANAHUAC",4305,2851,1924,127,9207,13927
19,6,"nl","APODACA",65651,65942,39997,6396,177986,313592
19,7,"nl","ARAMBERRI",5163,3530,342,72,9107,11127
19,8,"nl","BUSTAMANTE",1306,928,291,38,2563,3137
19,9,"nl","CADEREYTA JIMENEZ",16499,10503,8846,757,36605,63019
19,10,"nl","CARMEN",1958,1852,1202,290,5302,7940
19,11,"nl","CERRALVO",1616,1489,391,380,3876,6592
19,12,"nl","CIENEGA DE FLORES",3260,3478,2596,251,9585,16495
19,13,"nl","CHINA",2734,1876,675,688,5973,9536
19,14,"nl","DR. ARROYO",8566,4534,4770,665,18535,25684
19,15,"nl","DR. COSS",911,624,76,3,1614,2901
19,16,"nl","DR. GONZALEZ",824,573,643,20,2060,3004
19,17,"nl","GALEANA",10346,5352,1345,818,17861,28460
19,18,"nl","GARCIA",16022,14749,10503,988,42262,74818
19,19,"nl","SAN PEDRO GARZA GARCIA",15540,39608,10431,987,66566,98716
19,20,"nl","GRAL. BRAVO",1714,1365,345,36,3460,5556
19,21,"nl","GRAL. ESCOBEDO",40802,40193,26607,3599,111201,219447
19,22,"nl","GRAL. TERAN",4341,1583,650,886,7460,12563
19,23,"nl","GRAL. TREVI�O",597,464,48,8,1117,1777
19,24,"nl","GRAL. ZARAGOZA",1712,1369,201,10,3292,4006
19,25,"nl","GRAL. ZUAZUA",4470,4133,3168,278,12049,23271
19,26,"nl","GUADALUPE",97221,123534,74747,10165,305667,517564
19,27,"nl","LOS HERRERAS",720,523,281,295,1819,2763
19,28,"nl","HIDALGO",3203,2275,2580,280,8338,11841
19,29,"nl","HIGUERAS",477,459,73,12,1021,1257
19,30,"nl","HUALAHUISES",1799,1531,278,290,3898,5784
19,31,"nl","ITURBIDE",1115,616,557,19,2307,2804
19,32,"nl","JUAREZ",27403,25803,14072,1944,69222,132587
19,33,"nl","LAMPAZOS DE NARANJO",1439,1550,221,48,3258,4260
19,34,"nl","LINARES",13099,9387,5858,6122,34466,58714
19,35,"nl","MARIN",1537,1128,276,33,2974,4253
19,36,"nl","MELCHOR OCAMPO",407,242,88,177,914,1292
19,37,"nl","MIER Y NORIEGA",2027,2018,112,27,4184,5605
19,38,"nl","MINA",1601,757,781,37,3176,4177
19,39,"nl","MONTEMORELOS",14133,6968,6093,692,27886,45613
19,40,"nl","MONTERREY",171252,226586,125345,12453,535636,888129
19,41,"nl","PARAS",563,268,338,13,1182,1593
19,42,"nl","PESQUERIA",3488,3654,1188,138,8468,13539
19,43,"nl","LOS RAMONES",1519,1467,112,9,3107,5056
19,44,"nl","RAYONES",1046,1136,115,12,2309,2714
19,45,"nl","SABINAS HIDALGO",7171,5480,3331,502,16484,25881
19,46,"nl","SALINAS VICTORIA",6059,5204,2554,209,14026,22372
19,47,"nl","SAN NICOLAS DE LOS GARZA",55278,114801,54577,6856,231512,365670
19,48,"nl","SANTA CATARINA",30507,45140,24121,3729,103497,184448
19,49,"nl","SANTIAGO",8449,7971,4773,623,21816,32829
19,50,"nl","VALLECILLO",704,298,484,14,1500,2117
19,51,"nl","VILLALDAMA",1140,648,817,51,2656,3533
20,1,"oax","ABEJONES",96,52,231,0,379,906
20,2,"oax","ACATLAN DE PEREZ FIGUEROA",6514,8443,6045,265,21267,30297
20,3,"oax","ANIMAS TRUJANO",711,261,691,48,1711,2664
20,386,"oax","SANTA CRUZ XOXOCOTLAN",10477,5536,15200,695,31908,52842
20,4,"oax","ASUNCION CACALOTEPEC",149,472,281,6,908,1606
20,5,"oax","ASUNCION CUYOTEPEJI",235,226,51,1,513,835
20,6,"oax","ASUNCION IXTALTEPEC",3447,508,4154,48,8157,11469
20,7,"oax","ASUNCION NOCHIXTLAN",2908,869,4064,139,7980,11872
20,8,"oax","ASUNCION OCOTLAN",430,479,311,195,1415,2782
20,9,"oax","ASUNCION TLACOLULITA",152,49,227,1,429,647
20,10,"oax","AYOQUEZCO DE ALDAMA",267,773,623,39,1702,4001
20,11,"oax","AYOTZINTEPEC",1099,407,1211,12,2729,3976
20,12,"oax","EL BARRIO DE LA SOLEDAD",2432,1739,2144,67,6382,9727
20,13,"oax","CALIHUALA",78,27,214,0,319,930
20,14,"oax","CANDELARIA LOXICHA",1221,605,1581,24,3431,5936
20,15,"oax","CHAHUITES",1465,1233,1784,18,4500,7196
20,16,"oax","CHALCATONGO DE HIDALGO",1353,194,2283,54,3884,6053
20,17,"oax","CIENEGA DE ZIMATLAN",673,192,581,25,1471,2492
20,18,"oax","COATECAS ALTAS",800,411,428,12,1651,3967
20,19,"oax","COICOYAN DE LAS FLORES",537,48,1110,15,1710,4624
20,20,"oax","LA COMPA�IA",815,289,213,12,1329,2755
20,21,"oax","CONCEPCION BUENAVISTA",165,35,91,1,292,519
20,22,"oax","CONCEPCION PAPALO",194,93,1180,5,1472,2048
20,23,"oax","CONSTANCIA DEL ROSARIO",154,55,1348,4,1561,2660
20,24,"oax","COSOLAPA",1692,1748,2482,51,5973,9175
20,25,"oax","COSOLTEPEC",184,28,232,2,446,688
20,26,"oax","CUILAPAM DE GUERRERO",2502,1252,2979,162,6895,12127
20,27,"oax","CUYAMECALCO VILLA DE ZARAGOZA",401,181,706,13,1301,2449
20,28,"oax","HEROICA CIUDAD DE EJUTLA DE CRESPO",4175,3781,1741,139,9836,15415
20,29,"oax","ELOXOCHITLAN DE FLORES MAGON",585,139,668,4,1396,2407
20,30,"oax","EL ESPINAL",1942,228,2464,30,4664,6337
20,31,"oax","FRESNILLO DE TRUJANO",234,34,156,2,426,841
20,32,"oax","GUADALUPE DE RAMIREZ",319,50,315,4,688,1235
20,33,"oax","GUADALUPE ETLA",361,140,497,23,1021,1744
20,34,"oax","GUELATAO DE JUAREZ",85,18,176,1,280,413
20,35,"oax","GUEVEA DE HUMBOLDT",1109,295,721,4,2129,3608
20,36,"oax","MESONES HIDALGO",321,172,864,10,1367,3325
20,37,"oax","HEROICA CIUDAD DE HUAJUAPAN DE LEON",9558,6489,11249,405,27701,49783
20,38,"oax","HUAUTEPEC",1457,283,998,13,2751,3462
20,39,"oax","HUAUTLA DE JIMENEZ",6083,1336,7639,61,15119,19500
20,40,"oax","IXPANTEPEC NIEVES",142,65,233,5,445,1295
20,41,"oax","CIUDAD IXTEPEC",4957,1736,6137,128,12958,18727
20,42,"oax","IXTLAN DE JUAREZ",911,759,1726,50,3446,5062
20,43,"oax","JUCHITAN DE ZARAGOZA",14273,2619,22423,293,39608,63546
20,44,"oax","LOMA BONITA",5229,5590,6222,232,17273,27534
20,45,"oax","MAGDALENA APASCO",942,463,1099,56,2560,4405
20,46,"oax","MAGDALENA JALTEPEC",488,176,500,12,1176,2496
20,47,"oax","MAGDALENA MIXTEPEC",61,206,120,5,392,668
20,48,"oax","MAGDALENA OCOTLAN",229,41,199,5,474,773
20,49,"oax","MAGDALENA PE�ASCO",136,89,1056,15,1296,2387
20,50,"oax","MAGDALENA TEITIPAC",205,353,235,7,800,2474
20,51,"oax","MAGDALENA TEQUISISTLAN",1031,342,1712,15,3100,5024
20,52,"oax","MAGDALENA TLACOTEPEC",227,51,366,5,649,1024
20,53,"oax","MAGDALENA YODOCONO DE PORFIRIO DIAZ",190,119,197,4,510,944
20,54,"oax","MAGDALENA ZAHUATLAN",73,28,83,5,189,322
20,55,"oax","MARISCALA DE JUAREZ",783,166,652,15,1616,2737
20,56,"oax","MARTIRES DE TACUBAYA",260,111,281,1,653,1030
20,57,"oax","MATIAS ROMERO AVENDA�O",6353,4295,6895,172,17715,27803
20,58,"oax","MAZATLAN VILLA DE FLORES",1891,818,2169,50,4928,7836
20,59,"oax","MIAHUATLAN DE PORFIRIO DIAZ",4540,4329,6535,257,15661,29238
20,60,"oax","MIXISTLAN DE LA REFORMA",467,144,250,4,865,1595
20,61,"oax","MONJAS",545,220,202,15,982,2087
20,62,"oax","NATIVIDAD",94,73,84,4,255,453
20,63,"oax","NAZARENO ETLA",570,234,1073,25,1902,2949
20,64,"oax","NEJAPA DE MADERO",1043,1075,796,16,2930,5340
20,65,"oax","NUEVO ZOQUIAPAM",112,148,229,6,495,1062
20,66,"oax","OAXACA DE JUAREZ",42489,29599,66360,2559,141007,212379
20,67,"oax","OCOTLAN DE MORELOS",2839,2222,4424,175,9660,14840
20,68,"oax","LA PE",403,134,155,4,696,1361
20,69,"oax","PINOTEPA DE DON LUIS",1593,80,1496,11,3180,4367
20,70,"oax","PLUMA HIDALGO",610,371,485,9,1475,2123
20,71,"oax","PUTLA VILLA DE GUERRERO",3239,1181,7811,112,12343,22205
20,72,"oax","REFORMA DE PINEDA",678,137,530,9,1354,1993
20,73,"oax","LA REFORMA",336,124,626,9,1095,2300
20,74,"oax","REYES ETLA",450,191,695,23,1359,2468
20,75,"oax","ROJAS DE CUAUHTEMOC",176,121,196,15,508,862
20,76,"oax","SALINA CRUZ",10395,7708,16922,371,35396,56828
20,77,"oax","SAN AGUSTIN AMATENGO",260,245,296,12,813,1420
20,78,"oax","SAN AGUSTIN ATENANGO",331,27,385,10,753,1767
20,79,"oax","SAN AGUSTIN CHAYUCO",602,175,955,6,1738,3017
20,80,"oax","SAN AGUSTIN DE LAS JUNTAS",1012,623,1202,85,2922,5139
20,81,"oax","SAN AGUSTIN ETLA",527,265,859,25,1676,2714
20,82,"oax","SAN AGUSTIN LOXICHA",3658,998,3390,66,8112,13643
20,83,"oax","SAN AGUSTIN TLACOTEPEC",65,17,291,1,374,669
20,84,"oax","SAN AGUSTIN YATARENI",278,378,313,34,1003,2721
20,85,"oax","SAN ANDRES CABECERA NUEVA",414,140,542,6,1102,1933
20,86,"oax","SAN ANDRES DINICUITI",478,59,335,13,885,1659
20,87,"oax","SAN ANDRES HUAXPALTEPEC",941,328,1081,14,2364,4102
20,88,"oax","SAN ANDRES HUAYAPAM",580,393,871,51,1895,3198
20,89,"oax","SAN ANDRES IXTLAHUACA",164,127,306,6,603,1180
20,90,"oax","SAN ANDRES LAGUNAS",96,24,105,2,227,368
20,91,"oax","SAN ANDRES NUXI�O",499,88,87,2,676,1274
20,92,"oax","SAN ANDRES PAXTLAN",579,282,349,9,1219,2603
20,93,"oax","SAN ANDRES SINAXTLA",136,60,137,5,338,533
20,94,"oax","SAN ANDRES SOLAGA",110,68,344,2,524,1183
20,95,"oax","SAN ANDRES TEOTILALPAM",563,450,584,6,1603,2578
20,96,"oax","SAN ANDRES TEPETLAPA",66,42,21,0,129,356
20,97,"oax","SAN ANDRES YAA",22,21,184,1,228,415
20,98,"oax","SAN ANDRES ZABACHE",149,48,47,6,250,638
20,99,"oax","SAN ANDRES ZAUTLA",793,108,919,29,1849,2683
20,100,"oax","SAN ANTONINO CASTILLO VELASCO",710,188,1157,63,2118,3657
20,101,"oax","SAN ANTONINO EL ALTO",327,218,261,7,813,1498
20,102,"oax","SAN ANTONINO MONTE VERDE",1597,161,342,15,2115,4298
20,103,"oax","SAN ANTONIO ACUTLA",45,13,82,2,142,219
20,104,"oax","SAN ANTONIO DE LA CAL",2001,1794,3238,218,7251,13224
20,105,"oax","SAN ANTONIO HUITEPEC",210,411,1040,21,1682,2853
20,106,"oax","SAN ANTONIO NANAHUATIPAM",242,73,349,9,673,961
20,107,"oax","SAN ANTONIO SINICAHUA",157,39,278,4,478,927
20,108,"oax","SAN ANTONIO TEPETLAPA",418,72,692,8,1190,2513
20,109,"oax","SAN BALTAZAR CHICHICAPAM",556,189,764,18,1527,2239
20,110,"oax","SAN BALTAZAR LOXICHA",486,99,443,4,1032,1890
20,111,"oax","SAN BALTAZAR YATZACHI EL BAJO",36,65,208,1,310,580
20,112,"oax","SAN BARTOLO COYOTEPEC",1300,686,1929,99,4014,5589
20,113,"oax","SAN BARTOLO SOYALTEPEC",89,44,154,1,288,506
20,114,"oax","SAN BARTOLO YAUTEPEC",106,161,80,0,347,522
20,115,"oax","SAN BARTOLOME AYAUTLA",591,320,909,10,1830,2480
20,116,"oax","SAN BARTOLOME LOXICHA",193,228,358,4,783,1487
20,117,"oax","SAN BARTOLOME QUIALANA",136,278,82,11,507,2021
20,118,"oax","SAN BARTOLOME YUCUA�E",45,48,44,0,137,277
20,119,"oax","SAN BARTOLOME ZOOGOCHO",22,11,107,0,140,286
20,120,"oax","SAN BERNARDO MIXTEPEC",353,262,372,10,997,2136
20,121,"oax","SAN BLAS ATEMPA",4255,548,4167,48,9018,12131
20,122,"oax","SAN CARLOS YAUTEPEC",1438,1674,1058,13,4183,6902
20,123,"oax","SAN CRISTOBAL AMATLAN",334,691,537,21,1583,3054
20,124,"oax","SAN CRISTOBAL AMOLTEPEC",69,12,362,1,444,805
20,125,"oax","SAN CRISTOBAL LACHIRIOAG",248,72,302,3,625,1045
20,126,"oax","SAN CRISTOBAL SUCHIXTLAHUACA",61,26,70,1,158,241
20,127,"oax","SAN DIONISIO DEL MAR",1454,230,889,2,2575,3735
20,128,"oax","SAN DIONISIO OCOTEPEC",1739,645,1354,154,3892,6985
20,129,"oax","SAN DIONISIO OCOTLAN",243,87,165,14,509,859
20,130,"oax","SAN ESTEBAN ATATLAHUCA",169,91,1357,5,1622,2454
20,131,"oax","SAN FELIPE JALAPA DE DIAZ",6183,1323,4972,43,12521,16554
20,132,"oax","SAN FELIPE TEJALAPAM",692,400,951,33,2076,4550
20,133,"oax","SAN FELIPE USILA",2611,1744,1894,5,6254,7650
20,134,"oax","SAN FRANCISCO CAHUACUA",176,365,463,5,1009,1910
20,135,"oax","SAN FRANCISCO CAJONOS",11,17,138,1,167,382
20,136,"oax","SAN FRANCISCO CHAPULAPA",332,105,379,1,817,1170
20,137,"oax","SAN FRANCISCO CHINDUA",159,9,159,0,327,524
20,138,"oax","SAN FRANCISCO DEL MAR",1546,136,1155,4,2841,4572
20,139,"oax","SAN FRANCISCO HUEHUETLAN",126,49,216,2,393,763
20,140,"oax","SAN FRANCISCO IXHUATAN",1859,452,1987,8,4306,6316
20,141,"oax","SAN FRANCISCO JALTEPETONGO",223,31,230,5,489,798
20,142,"oax","SAN FRANCISCO LACHIGOLO",337,181,411,33,962,1800
20,143,"oax","SAN FRANCISCO LOGUECHE",199,177,288,6,670,1437
20,144,"oax","SAN FRANCISCO NUXA�O",109,7,25,2,143,266
20,145,"oax","SAN FRANCISCO OZOLOTEPEC",104,129,314,4,551,1134
20,146,"oax","SAN FRANCISCO SOLA",130,174,140,7,451,968
20,147,"oax","SAN FRANCISCO TELIXTLAHUACA",2235,592,2391,75,5293,7931
20,148,"oax","SAN FRANCISCO TEOPAN",117,9,58,1,185,260
20,149,"oax","SAN FRANCISCO TLAPANCINGO",166,60,273,0,499,1568
20,150,"oax","SAN GABRIEL MIXTEPEC",1035,198,725,8,1966,2906
20,151,"oax","SAN ILDEFONSO AMATLAN",467,327,78,4,876,1513
20,152,"oax","SAN ILDEFONSO SOLA",141,71,29,0,241,457
20,153,"oax","SAN ILDEFONSO VILLA ALTA",414,133,918,7,1472,2516
20,154,"oax","SAN JACINTO AMILPAS",1857,965,2850,104,5776,8779
20,155,"oax","SAN JACINTO TLACOTEPEC",149,193,239,3,584,1475
20,156,"oax","SAN JERONIMO COATLAN",644,470,450,27,1591,2892
20,157,"oax","SAN JERONIMO SILACAYOAPILLA",408,256,129,8,801,1517
20,158,"oax","SAN JERONIMO SOSOLA",347,317,421,13,1098,1910
20,159,"oax","SAN JERONIMO TAVICHE",236,68,183,6,493,1031
20,160,"oax","SAN JERONIMO TECOATL",283,39,277,3,602,1067
20,161,"oax","SAN JERONIMO TLACOCHAHUAYA",943,413,796,62,2214,3922
20,162,"oax","SAN JORGE NUCHITA",245,55,387,3,690,2380
20,163,"oax","SAN JOSE AYUQUILA",266,27,235,2,530,986
20,164,"oax","SAN JOSE CHILTEPEC",1802,1514,2383,42,5741,7909
20,165,"oax","SAN JOSE DEL PE�ASCO",547,62,72,5,686,1343
20,166,"oax","SAN JOSE ESTANCIA GRANDE",205,44,111,5,365,670
20,167,"oax","SAN JOSE INDEPENDENCIA",811,837,380,7,2035,2879
20,168,"oax","SAN JOSE LACHIGUIRI",491,276,561,22,1350,2540
20,169,"oax","SAN JOSE DEL PROGRESO",1127,538,839,28,2532,4224
20,170,"oax","SAN JOSE TENANGO",2728,911,3968,6,7613,10625
20,171,"oax","SAN JUAN ACHIUTLA",96,2,130,0,228,351
20,172,"oax","SAN JUAN ATEPEC",222,96,280,11,609,1150
20,173,"oax","SAN JUAN BAUTISTA ATATLAHUCA",249,189,217,3,658,1119
20,174,"oax","SAN JUAN BAUTISTA COIXTLAHUACA",555,119,470,15,1159,1955
20,175,"oax","SAN JUAN BAUTISTA CUICATLAN",2149,846,2147,45,5187,6901
20,176,"oax","SAN JUAN BAUTISTA GUELACHE",680,365,948,35,2028,3635
20,177,"oax","SAN JUAN BAUTISTA JAYACATLAN",244,123,92,1,460,969
20,178,"oax","SAN JUAN BAUTISTA LO DE SOTO",404,107,558,12,1081,1833
20,179,"oax","SAN JUAN BAUTISTA SUCHITEPEC",158,90,20,2,270,367
20,180,"oax","SAN JUAN BAUTISTA TLACHICHILCO",143,152,113,1,409,996
20,181,"oax","SAN JUAN BAUTISTA TLACOATZINTEPEC",283,149,568,4,1004,1520
20,182,"oax","SAN JUAN BAUTISTA TUXTEPEC",21323,17696,28211,988,68218,106349
20,183,"oax","SAN JUAN BAUTISTA VALLE NACIONAL",3628,1077,5962,63,10730,16386
20,184,"oax","SAN JUAN CACAHUATEPEC",1503,277,1982,32,3794,5967
20,185,"oax","SAN JUAN CHICOMEZUCHIL",63,40,46,3,152,245
20,186,"oax","SAN JUAN CHILATECA",335,144,335,21,835,1149
20,187,"oax","CHIQUIHUITLAN DE BENITO JUAREZ",563,145,417,5,1130,1641
20,188,"oax","SAN JUAN CIENEGUILLA",98,32,114,0,244,418
20,189,"oax","SAN JUAN COATZOSPAM",453,41,382,1,877,1379
20,190,"oax","SAN JUAN COLORADO",1507,146,2158,14,3825,5549
20,191,"oax","SAN JUAN COMALTEPEC",238,283,276,6,803,1513
20,192,"oax","SAN JUAN COTZOCON",3556,1579,3115,50,8300,14766
20,193,"oax","SAN JUAN DE LOS CUES",433,262,489,9,1193,1689
20,194,"oax","SAN JUAN DEL ESTADO",292,396,225,17,930,1749
20,195,"oax","SAN JUAN DEL RIO",222,200,146,9,577,1073
20,196,"oax","SAN JUAN DIUXI",132,46,277,1,456,834
20,197,"oax","SAN JUAN EVANGELISTA ANALCO",65,37,130,3,235,354
20,198,"oax","SAN JUAN GUELAVIA",397,176,245,13,831,2211
20,199,"oax","SAN JUAN GUICHICOVI",5742,813,8236,54,14845,20558
20,200,"oax","SAN JUAN IHUALTEPEC",159,109,31,0,299,655
20,201,"oax","SAN JUAN JUQUILA MIXES",201,415,403,39,1058,2252
20,202,"oax","SAN JUAN JUQUILA VIJANOS",197,118,280,0,595,1226
20,203,"oax","SAN JUAN LACHAO",574,245,496,11,1326,2637
20,204,"oax","SAN JUAN LACHIGALLA",500,473,123,7,1103,2057
20,205,"oax","SAN JUAN LAJARCIA",126,47,163,4,340,585
20,206,"oax","SAN JUAN LALANA",1936,2329,2390,42,6697,10049
20,207,"oax","SAN JUAN MAZATLAN",2460,1222,1908,33,5623,10230
20,208,"oax","SAN JUAN MIXTEPEC",639,117,2156,43,2955,7698
20,209,"oax","SAN JUAN MIXTEPEC",40,118,122,2,282,537
20,210,"oax","SAN JUAN �UMI",989,205,1023,10,2227,4717
20,211,"oax","SAN JUAN OZOLOTEPEC",229,162,466,3,860,1665
20,212,"oax","SAN JUAN PETLAPA",149,93,421,5,668,1504
20,213,"oax","SAN JUAN QUIAHIJE",349,292,433,14,1088,2443
20,214,"oax","SAN JUAN QUIOTEPEC",270,188,406,6,870,1854
20,215,"oax","SAN JUAN SAYULTEPEC",140,45,129,6,320,565
20,216,"oax","SAN JUAN TABAA",85,11,161,0,257,761
20,217,"oax","SAN JUAN TAMAZOLA",474,47,473,8,1002,1956
20,218,"oax","SAN JUAN TEITA",80,15,108,0,203,442
20,219,"oax","SAN JUAN TEITIPAC",412,244,215,14,885,1992
20,220,"oax","SAN JUAN TEPEUXILA",214,224,569,4,1011,1801
20,221,"oax","SAN JUAN TEPOSCOLULA",202,57,285,7,551,961
20,222,"oax","SAN JUAN YAEE",86,113,203,2,404,959
20,223,"oax","SAN JUAN YATZONA",103,43,69,0,215,323
20,224,"oax","SAN JUAN YUCUITA",122,45,160,4,331,561
20,225,"oax","SAN LORENZO",577,396,1297,10,2280,3591
20,226,"oax","SAN LORENZO ALBARRADAS",533,303,186,20,1042,1924
20,227,"oax","SAN LORENZO CACAOTEPEC",1628,965,2626,91,5310,8884
20,228,"oax","SAN LORENZO CUAUNECUILTITLA",143,53,123,1,320,453
20,229,"oax","SAN LORENZO TEXMELUCAN",639,337,424,4,1404,3576
20,230,"oax","SAN LORENZO VICTORIA",193,40,169,5,407,835
20,231,"oax","SAN LUCAS CAMOTLAN",172,173,88,2,435,1467
20,232,"oax","SAN LUCAS OJITLAN",3501,2919,4101,42,10563,13694
20,233,"oax","SAN LUCAS QUIAVINI",148,122,83,9,362,1362
20,234,"oax","SAN LUCAS ZOQUIAPAM",886,575,1269,13,2743,4249
20,235,"oax","SAN LUIS AMATLAN",636,296,542,16,1490,2558
20,236,"oax","SAN MARCIAL OZOLOTEPEC",80,198,201,1,480,891
20,237,"oax","SAN MARCOS ARTEAGA",434,113,338,4,889,1811
20,238,"oax","SAN MARTIN DE LOS CANSECOS",204,20,155,6,385,607
20,239,"oax","SAN MARTIN HUAMELULPAM",83,27,317,6,433,785
20,240,"oax","SAN MARTIN ITUNYOSO",268,28,532,5,833,1763
20,241,"oax","SAN MARTIN LACHILA",205,148,128,5,486,923
20,242,"oax","SAN MARTIN PERAS",993,528,1506,38,3065,7244
20,243,"oax","SAN MARTIN TILCAJETE",234,136,263,13,646,1316
20,244,"oax","SAN MARTIN TOXPALAN",372,152,855,3,1382,2265
20,245,"oax","SAN MARTIN ZACATEPEC",308,19,248,0,575,1224
20,246,"oax","SAN MATEO CAJONOS",95,30,107,2,234,474
20,248,"oax","SAN MATEO ETLATONGO",183,39,194,3,419,769
20,249,"oax","SAN MATEO NEJAPAM",97,62,85,3,247,751
20,250,"oax","SAN MATEO PE�ASCO",298,90,331,29,748,1385
20,251,"oax","SAN MATEO PI�AS",424,163,340,4,931,1547
20,252,"oax","SAN MATEO RIO HONDO",499,516,310,12,1337,2347
20,253,"oax","SAN MATEO SINDIHUI",0,0,1,0,1,1400
20,254,"oax","SAN MATEO TLAPILTEPEC",42,20,50,0,112,165
20,255,"oax","SAN MATEO YOLOXOCHITLAN",466,275,623,7,1371,2152
20,256,"oax","SAN MELCHOR BETAZA",99,35,206,2,342,820
20,257,"oax","SAN MIGUEL ACHIUTLA",134,20,88,0,242,570
20,258,"oax","SAN MIGUEL AHUEHUETITLAN",510,467,42,0,1019,1924
20,259,"oax","SAN MIGUEL ALOAPAM",294,264,337,15,910,1639
20,260,"oax","SAN MIGUEL AMATITLAN",1630,761,431,7,2829,4551
20,261,"oax","SAN MIGUEL AMATLAN",257,60,112,2,431,722
20,262,"oax","SAN MIGUEL CHICAHUA",220,110,508,11,849,1550
20,263,"oax","SAN MIGUEL CHIMALAPA",1652,193,784,9,2638,4342
20,264,"oax","SAN MIGUEL COATLAN",335,300,237,5,877,1900
20,265,"oax","SAN MIGUEL DEL PUERTO",1177,744,1091,25,3037,5244
20,266,"oax","SAN MIGUEL DEL RIO",37,16,71,1,125,234
20,267,"oax","SAN MIGUEL EJUTLA",230,106,71,7,414,695
20,268,"oax","SAN MIGUEL EL GRANDE",164,80,1727,6,1977,2628
20,269,"oax","SAN MIGUEL HUAUTLA",303,30,103,1,437,881
20,270,"oax","SAN MIGUEL MIXTEPEC",216,413,349,7,985,1845
20,271,"oax","SAN MIGUEL PANIXTLAHUACA",317,521,899,12,1749,3551
20,272,"oax","SAN MIGUEL PERAS",451,375,394,10,1230,1996
20,273,"oax","SAN MIGUEL PIEDRAS",0,0,0,0,0,829
20,274,"oax","SAN MIGUEL QUETZALTEPEC",678,259,528,11,1476,4324
20,275,"oax","SAN MIGUEL SANTA FLOR",169,23,115,0,307,582
20,276,"oax","SAN MIGUEL SOYALTEPEC",10170,5055,4763,100,20088,24354
20,277,"oax","SAN MIGUEL SUCHIXTEPEC",173,268,576,8,1025,1888
20,278,"oax","VILLA TALEA DE CASTRO",272,141,447,5,865,1673
20,279,"oax","SAN MIGUEL TECOMATLAN",91,54,17,1,163,241
20,280,"oax","SAN MIGUEL TENANGO",200,9,164,2,375,598
20,281,"oax","SAN MIGUEL TEQUIXTEPEC",161,83,105,3,352,695
20,282,"oax","SAN MIGUEL TILQUIAPAM",325,107,391,8,831,2135
20,283,"oax","SAN MIGUEL TLACAMAMA",619,290,382,7,1298,2259
20,284,"oax","SAN MIGUEL TLACOTEPEC",246,237,578,17,1078,2483
20,285,"oax","SAN MIGUEL TULANCINGO",60,27,66,3,156,273
20,286,"oax","SAN MIGUEL YOTAO",98,47,85,0,230,384
20,287,"oax","SAN NICOLAS",200,238,64,8,510,886
20,288,"oax","SAN NICOLAS HIDALGO",177,19,219,0,415,792
20,289,"oax","SAN PABLO COATLAN",420,273,763,21,1477,2643
20,290,"oax","SAN PABLO CUATRO VENADOS",260,127,108,7,502,835
20,291,"oax","SAN PABLO ETLA",1592,1097,2502,112,5303,8673
20,292,"oax","SAN PABLO HUITZO",1332,570,1296,40,3238,4728
20,293,"oax","SAN PABLO HUIXTEPEC",1740,987,1487,75,4289,6882
20,294,"oax","SAN PABLO MACUILTIANGUIS",144,60,237,7,448,817
20,295,"oax","SAN PABLO TIJALTEPEC",127,18,436,17,598,1433
20,296,"oax","SAN PABLO VILLA DE MITLA",2432,1385,1813,88,5718,7829
20,297,"oax","SAN PABLO YAGANIZA",102,22,180,6,310,746
20,298,"oax","SAN PEDRO AMUZGOS",1195,127,1441,3,2766,4339
20,299,"oax","SAN PEDRO APOSTOL",174,143,269,21,607,1277
20,300,"oax","SAN PEDRO ATOYAC",532,219,750,10,1511,2641
20,301,"oax","SAN PEDRO CAJONOS",73,47,297,2,419,797
20,302,"oax","SAN PEDRO COXCALTEPEC CANTAROS",122,18,175,4,319,609
20,303,"oax","SAN PEDRO COMITANCILLO",909,48,1297,14,2268,3240
20,304,"oax","SAN PEDRO EL ALTO",510,185,562,6,1263,2108
20,305,"oax","SAN PEDRO HUAMELULA",1633,460,1885,27,4005,6708
20,306,"oax","SAN PEDRO HUILOTEPEC",550,260,521,11,1342,1986
20,307,"oax","SAN PEDRO IXCATLAN",2084,1866,1282,22,5254,6876
20,308,"oax","SAN PEDRO IXTLAHUACA",759,444,765,42,2010,4373
20,309,"oax","SAN PEDRO JALTEPETONGO",98,21,55,1,175,364
20,310,"oax","SAN PEDRO JICAYAN",1566,332,1765,20,3683,6864
20,311,"oax","SAN PEDRO JOCOTIPAC",107,13,211,0,331,637
20,312,"oax","SAN PEDRO JUCHATENGO",543,79,109,5,736,1154
20,313,"oax","SAN PEDRO MARTIR",214,180,216,10,620,1365
20,314,"oax","SAN PEDRO MARTIR QUIECHAPA",95,68,155,3,321,573
20,315,"oax","SAN PEDRO MARTIR YUCUXACO",106,63,294,3,466,986
20,316,"oax","SAN PEDRO MIXTEPEC",5565,3291,9825,183,18864,29337
20,317,"oax","SAN PEDRO MIXTEPEC",58,123,204,4,389,757
20,318,"oax","SAN PEDRO MOLINOS",104,26,178,6,314,536
20,319,"oax","SAN PEDRO NOPALA",107,92,52,5,256,538
20,320,"oax","SAN PEDRO OCOPETATILLO",216,70,47,5,338,534
20,321,"oax","SAN PEDRO OCOTEPEC",210,126,98,2,436,1136
20,322,"oax","SAN PEDRO POCHUTLA",6555,3830,8344,167,18896,28316
20,323,"oax","SAN PEDRO QUIATONI",2549,410,953,148,4060,6217
20,324,"oax","SAN PEDRO SOCHIAPAM",669,318,519,19,1525,2607
20,325,"oax","SAN PEDRO TAPANATEPEC",2287,1929,1476,19,5711,9208
20,326,"oax","SAN PEDRO TAVICHE",144,81,98,4,327,641
20,327,"oax","SAN PEDRO TEOZACOALCO",0,0,0,0,0,841
20,328,"oax","SAN PEDRO TEUTILA",747,389,730,23,1889,2721
20,329,"oax","SAN PEDRO TIDAA",110,40,194,3,347,587
20,330,"oax","SAN PEDRO TOPILTEPEC",52,20,129,4,205,296
20,331,"oax","SAN PEDRO TOTOLAPA",338,318,350,18,1024,2132
20,332,"oax","VILLA DE TUTUTEPEC DE MELCHOR OCAMPO",7163,1318,9522,120,18123,30696
20,333,"oax","SAN PEDRO Y SAN PABLO AYUTLA",317,516,577,22,1432,3369
20,334,"oax","SAN PEDRO Y SAN PABLO TEPOSCOLULA",725,149,921,15,1810,2850
20,335,"oax","SAN PEDRO Y SAN PABLO TEQUIXTEPEC",399,125,360,9,893,1502
20,336,"oax","SAN PEDRO YANERI",131,40,165,1,337,616
20,337,"oax","SAN PEDRO YOLOX",166,353,423,4,946,1811
20,338,"oax","SAN PEDRO YUCUNAMA",73,12,37,2,124,164
20,339,"oax","SAN RAYMUNDO JALPAN",273,244,342,15,874,1443
20,340,"oax","SAN SEBASTIAN ABASOLO",303,229,170,16,718,1432
20,341,"oax","SAN SEBASTIAN COATLAN",834,223,77,1,1135,1661
20,342,"oax","SAN SEBASTIAN IXCAPA",650,136,1006,11,1803,2873
20,343,"oax","SAN SEBASTIAN NICANANDUTA",188,53,195,5,441,1292
20,344,"oax","SAN SEBASTIAN RIO HONDO",846,255,366,8,1475,2281
20,345,"oax","SAN SEBASTIAN TECOMAXTLAHUACA",582,432,1646,24,2684,6031
20,346,"oax","SAN SEBASTIAN TEITIPAC",297,172,282,13,764,1598
20,347,"oax","SAN SEBASTIAN TUTLA",2301,1451,3898,160,7810,11534
20,348,"oax","SAN SIMON ALMOLONGAS",279,353,256,22,910,2241
20,349,"oax","SAN SIMON ZAHUATLAN",534,24,239,1,798,1712
20,350,"oax","SAN VICENTE COATLAN",184,161,161,6,512,2642
20,351,"oax","SAN VICENTE LACHIXIO",247,128,144,8,527,1628
20,352,"oax","SAN VICENTE NU�U",147,64,35,3,249,373
20,353,"oax","SANTA ANA",445,266,119,9,839,1444
20,354,"oax","SANTA ANA ATEIXTLAHUACA",121,41,41,0,203,305
20,355,"oax","SANTA ANA CUAUHTEMOC",117,42,136,0,295,492
20,356,"oax","SANTA ANA DEL VALLE",187,163,200,32,582,1680
20,357,"oax","SANTA ANA TAVELA",296,38,48,3,385,686
20,358,"oax","SANTA ANA TLAPACOYAN",269,300,255,13,837,1719
20,359,"oax","SANTA ANA YARENI",66,40,225,3,334,728
20,360,"oax","SANTA ANA ZEGACHE",644,219,675,22,1560,2827
20,361,"oax","SANTA CATALINA QUIERI",55,47,202,4,308,665
20,362,"oax","SANTA CATARINA CUIXTLA",172,208,191,10,581,1061
20,363,"oax","SANTA CATARINA IXTEPEJI",602,203,308,7,1120,1872
20,364,"oax","SANTA CATARINA JUQUILA",3490,1229,2468,69,7256,9848
20,365,"oax","SANTA CATARINA LACHATAO",333,120,216,11,680,1080
20,366,"oax","SANTA CATARINA LOXICHA",392,87,442,8,929,2249
20,367,"oax","SANTA CATARINA MECHOACAN",700,146,573,10,1429,2525
20,368,"oax","SANTA CATARINA MINAS",178,235,286,17,716,1316
20,369,"oax","SANTA CATARINA QUIANE",393,231,296,7,927,1530
20,370,"oax","SANTA CATARINA QUIOQUITANI",49,19,116,1,185,306
20,371,"oax","SANTA CATARINA TAYATA",148,26,131,3,308,472
20,372,"oax","SANTA CATARINA TICUA",120,61,264,8,453,697
20,373,"oax","SANTA CATARINA YOSONOTU",48,18,542,2,610,1168
20,374,"oax","SANTA CATARINA ZAPOQUILA",118,18,84,1,221,371
20,375,"oax","SANTA CRUZ ACATEPEC",278,70,265,2,615,811
20,376,"oax","SANTA CRUZ AMILPAS",1515,876,2088,92,4571,7061
20,377,"oax","SANTA CRUZ DE BRAVO",65,12,62,8,147,334
20,378,"oax","SANTA CRUZ ITUNDUJIA",1884,231,2487,15,4617,6868
20,379,"oax","SANTA CRUZ MIXTEPEC",387,418,551,27,1383,2556
20,380,"oax","SANTA CRUZ NUNDACO",126,60,701,9,896,1948
20,381,"oax","SANTA CRUZ PAPALUTLA",267,78,302,10,657,1326
20,382,"oax","SANTA CRUZ TACACHE DE MINA",602,117,438,1,1158,2085
20,383,"oax","SANTA CRUZ TACAHUA",126,34,232,3,395,801
20,384,"oax","SANTA CRUZ TAYATA",142,17,98,3,260,377
20,385,"oax","SANTA CRUZ XITLA",676,149,479,13,1317,3037
20,387,"oax","SANTA CRUZ ZENZONTEPEC",1551,604,1995,22,4172,9266
20,388,"oax","SANTA GERTRUDIS",632,289,497,25,1443,2422
20,389,"oax","SANTA INES DEL MONTE",226,206,197,3,632,1495
20,390,"oax","SANTA INES YATZECHE",99,36,76,4,215,763
20,391,"oax","SANTA INES DE ZARAGOZA",381,54,207,1,643,1187
20,392,"oax","SANTA LUCIA DEL CAMINO",6683,4416,12308,425,23832,36627
20,393,"oax","SANTA LUCIA MIAHUATLAN",499,74,152,4,729,1866
20,394,"oax","SANTA LUCIA MONTEVERDE",465,154,1340,13,1972,4139
20,395,"oax","SANTA LUCIA OCOTLAN",504,186,302,17,1009,2549
20,396,"oax","SANTA MAGDALENA JICOTLAN",40,5,9,1,55,66
20,397,"oax","SANTA MARIA ALOTEPEC",229,223,480,11,943,1844
20,398,"oax","SANTA MARIA APAZCO",252,32,347,5,636,1259
20,399,"oax","SANTA MARIA LA ASUNCION",600,672,93,15,1380,1944
20,400,"oax","SANTA MARIA ATZOMPA",2665,1642,4434,202,8943,17174
20,401,"oax","SANTA MARIA CAMOTLAN",376,81,370,8,835,1397
20,402,"oax","SANTA MARIA CHACHOAPAM",92,68,184,3,347,611
20,403,"oax","VILLA DE CHILAPA DE DIAZ",382,124,354,15,875,1528
20,404,"oax","SANTA MARIA CHILCHOTLA",3753,1666,3289,51,8759,12497
20,405,"oax","SANTA MARIA CHIMALAPA",1159,611,703,24,2497,4308
20,406,"oax","SANTA MARIA COLOTEPEC",2685,1761,4079,77,8602,15123
20,407,"oax","SANTA MARIA CORTIJO",197,143,135,17,492,892
20,408,"oax","SANTA MARIA COYOTEPEC",468,201,346,20,1035,1781
20,409,"oax","SANTA MARIA DEL ROSARIO",112,7,101,1,221,368
20,410,"oax","SANTA MARIA DEL TULE",1289,653,1820,74,3836,6016
20,411,"oax","SANTA MARIA ECATEPEC",357,453,431,6,1247,2188
20,412,"oax","SANTA MARIA GUELACE",133,36,115,14,298,542
20,413,"oax","SANTA MARIA GUIENAGATI",570,99,366,4,1039,2006
20,414,"oax","SANTA MARIA HUATULCO",5515,4683,6988,144,17330,25776
20,415,"oax","SANTA MARIA HUAZOLOTITLAN",2049,412,2383,37,4881,7723
20,416,"oax","SANTA MARIA IPALAPA",584,311,902,16,1813,3353
20,417,"oax","SANTA MARIA IXCATLAN",205,50,43,0,298,382
20,418,"oax","SANTA MARIA JACATEPEC",1566,973,2137,93,4769,6892
20,419,"oax","SANTA MARIA JALAPA DEL MARQUES",1865,656,2701,32,5254,8554
20,420,"oax","SANTA MARIA JALTIANGUIS",37,22,185,0,244,491
20,421,"oax","SANTA MARIA LACHIXIO",97,154,102,6,359,912
20,422,"oax","SANTA MARIA MIXTEQUILLA",978,104,1225,11,2318,3177
20,423,"oax","SANTA MARIA NATIVITAS",96,42,156,5,299,480
20,424,"oax","SANTA MARIA NDUAYACO",169,37,79,3,288,430
20,425,"oax","SANTA MARIA OZOLOTEPEC",205,540,436,11,1192,2341
20,426,"oax","SANTA MARIA PAPALO",94,111,706,7,918,1376
20,427,"oax","SANTA MARIA PETAPA",2702,988,2666,61,6417,9812
20,428,"oax","SANTA MARIA PE�OLES",1270,177,1204,20,2671,4238
20,429,"oax","SANTA MARIA QUIEGOLANI",290,293,129,9,721,1101
20,430,"oax","SANTA MARIA SOLA",211,208,103,6,528,1083
20,431,"oax","SANTA MARIA TATALTEPEC",38,14,101,0,153,195
20,432,"oax","SANTA MARIA TECOMAVACA",483,21,422,4,930,1367
20,433,"oax","SANTA MARIA TEMAXCALAPA",77,15,252,0,344,699
20,434,"oax","SANTA MARIA TEMAXCALTEPEC",343,153,305,4,805,1488
20,435,"oax","SANTA MARIA TEOPOXCO",830,94,443,10,1377,2581
20,436,"oax","SANTA MARIA TEPANTLALI",298,198,216,3,715,1832
20,437,"oax","SANTA MARIA TEXCATITLAN",131,24,293,1,449,771
20,438,"oax","SANTA MARIA TLAHUITOLTEPEC",259,320,1186,16,1781,5144
20,439,"oax","SANTA MARIA TLALIXTAC",249,313,184,1,747,1032
20,440,"oax","SANTA MARIA TONAMECA",3577,2202,3761,50,9590,15253
20,441,"oax","SANTA MARIA TOTOLAPILLA",141,24,321,1,487,738
20,442,"oax","SANTA MARIA XADANI",903,746,1235,5,2889,5253
20,443,"oax","SANTA MARIA YALINA",33,19,87,3,142,246
20,444,"oax","SANTA MARIA YAVESIA",78,19,112,1,210,330
20,445,"oax","SANTA MARIA YOLOTEPEC",53,32,106,1,192,295
20,446,"oax","SANTA MARIA YOSOYUA",41,40,562,2,645,1032
20,447,"oax","SANTA MARIA YUCUHITI",617,263,1631,15,2526,4587
20,448,"oax","SANTA MARIA ZACATEPEC",1866,499,3525,53,5943,11188
20,449,"oax","SANTA MARIA ZANIZA",39,78,262,3,382,916
20,450,"oax","SANTA MARIA ZOQUITLAN",614,160,467,21,1262,2712
20,451,"oax","SANTIAGO AMOLTEPEC",339,108,683,11,1141,5558
20,452,"oax","SANTIAGO APOALA",232,71,192,3,498,836
20,453,"oax","SANTIAGO APOSTOL",407,388,426,45,1266,3189
20,454,"oax","SANTIAGO ASTATA",548,256,672,5,1481,2706
20,455,"oax","SANTIAGO ATITLAN",247,204,485,4,940,1798
20,456,"oax","SANTIAGO AYUQUILILLA",483,339,127,6,955,1747
20,457,"oax","SANTIAGO CACALOXTEPEC",491,361,48,7,907,1515
20,458,"oax","SANTIAGO CAMOTLAN",205,89,679,11,984,1929
20,459,"oax","SANTIAGO CHAZUMBA",1016,119,1039,21,2195,3297
20,460,"oax","SANTIAGO CHOAPAM",516,303,215,7,1041,3108
20,461,"oax","SANTIAGO COMALTEPEC",96,168,290,0,554,1155
20,462,"oax","SANTIAGO DEL RIO",79,37,118,1,235,538
20,463,"oax","SANTIAGO HUAJOLOTITLAN",1078,276,536,17,1907,3231
20,464,"oax","SANTIAGO HUAUCLILLA",89,32,166,1,288,466
20,465,"oax","SANTIAGO IHUITLAN PLUMAS",85,14,86,0,185,325
20,466,"oax","SANTIAGO IXCUINTEPEC",390,31,109,0,530,843
20,467,"oax","SANTIAGO IXTAYUTLA",827,345,2865,31,4068,6658
20,468,"oax","SANTIAGO JAMILTEPEC",3177,647,4305,88,8217,12784
20,469,"oax","SANTIAGO JOCOTEPEC",1765,1060,1987,19,4831,7633
20,470,"oax","SANTIAGO JUXTLAHUACA",3466,1538,5526,116,10646,21031
20,471,"oax","SANTIAGO LACHIGUIRI",783,163,726,5,1677,3393
20,515,"oax","SANTO DOMINGO TEHUANTEPEC",8304,5248,13597,324,27473,42755
20,472,"oax","SANTIAGO LALOPA",25,5,178,1,209,311
20,473,"oax","SANTIAGO LAOLLAGA",623,81,788,18,1510,2486
20,474,"oax","SANTIAGO LAXOPA",73,53,182,4,312,912
20,475,"oax","SANTIAGO LLANO GRANDE",721,88,722,5,1536,2686
20,476,"oax","SANTIAGO MATATLAN",989,1030,1231,104,3354,6598
20,477,"oax","SANTIAGO MILTEPEC",90,12,48,0,150,276
20,478,"oax","SANTIAGO MINAS",185,175,66,5,431,934
20,479,"oax","SANTIAGO NACALTEPEC",308,152,317,7,784,1468
20,480,"oax","SANTIAGO NEJAPILLA",89,10,17,3,119,174
20,481,"oax","SANTIAGO NILTEPEC",1199,368,1044,9,2620,3867
20,482,"oax","SANTIAGO NUNDICHE",130,41,207,4,382,712
20,483,"oax","SANTIAGO NUYOO",101,70,552,2,725,1484
20,484,"oax","SANTIAGO PINOTEPA NACIONAL",7693,2451,10251,211,20606,33863
20,485,"oax","SANTIAGO SUCHILQUITONGO",1852,515,1451,81,3899,6364
20,486,"oax","SANTIAGO TAMAZOLA",876,275,472,21,1644,3141
20,487,"oax","SANTIAGO TAPEXTLA",607,374,200,6,1187,1887
20,488,"oax","SANTIAGO TENANGO",290,190,312,19,811,1336
20,489,"oax","SANTIAGO TEPETLAPA",34,9,24,0,67,95
20,490,"oax","SANTIAGO TETEPEC",905,486,692,13,2096,3111
20,491,"oax","SANTIAGO TEXCALCINGO",802,49,112,5,968,1579
20,492,"oax","SANTIAGO TEXTITLAN",269,169,580,7,1025,2059
20,493,"oax","SANTIAGO TILANTONGO",478,142,550,22,1192,2165
20,494,"oax","SANTIAGO TILLO",154,23,116,10,303,442
20,495,"oax","SANTIAGO TLAZOYALTEPEC",551,373,696,9,1629,2847
20,496,"oax","SANTIAGO XANICA",346,301,339,8,994,1836
20,497,"oax","SANTIAGO XIACUI",389,129,257,10,785,1313
20,498,"oax","SANTIAGO YAITEPEC",497,68,958,16,1539,2296
20,499,"oax","SANTIAGO YAVEO",684,633,451,23,1791,3321
20,500,"oax","SANTIAGO YOLOMECATL",228,53,487,14,782,1390
20,501,"oax","SANTIAGO YOSONDUA",835,514,1653,18,3020,5336
20,502,"oax","SANTIAGO YUCUYACHI",77,57,167,0,301,909
20,503,"oax","SANTIAGO ZACATEPEC",542,381,525,6,1454,2950
20,504,"oax","SANTIAGO ZOOCHILA",41,18,129,1,189,314
20,505,"oax","SANTO DOMINGO ALBARRADAS",89,25,180,3,297,554
20,506,"oax","SANTO DOMINGO ARMENTA",499,339,346,1,1185,2242
20,507,"oax","SANTO DOMINGO CHIHUITAN",437,74,350,3,864,1249
20,508,"oax","SANTO DOMINGO DE MORELOS",708,388,1479,11,2586,5761
20,509,"oax","SANTO DOMINGO INGENIO",1300,920,1341,30,3591,6047
20,510,"oax","SANTO DOMINGO IXCATLAN",179,28,104,1,312,510
20,511,"oax","SANTO DOMINGO NUXAA",651,115,332,7,1105,1929
20,512,"oax","SANTO DOMINGO OZOLOTEPEC",97,136,63,3,299,641
20,513,"oax","SANTO DOMINGO PETAPA",1922,199,1942,5,4068,5931
20,514,"oax","SANTO DOMINGO ROAYAGA",206,12,80,0,298,550
20,516,"oax","SANTO DOMINGO TEOJOMULCO",488,277,620,14,1399,2769
20,517,"oax","SANTO DOMINGO TEPUXTEPEC",572,287,335,18,1212,2962
20,518,"oax","SANTO DOMINGO TLATAYAPAM",53,2,13,0,68,111
20,519,"oax","SANTO DOMINGO TOMALTEPEC",283,354,479,16,1132,2157
20,520,"oax","SANTO DOMINGO TONALA",806,207,1362,32,2407,5726
20,521,"oax","SANTO DOMINGO TONALTEPEC",80,15,47,3,145,210
20,522,"oax","SANTO DOMINGO XAGACIA",121,16,166,0,303,670
20,523,"oax","SANTO DOMINGO YANHUITLAN",214,118,312,10,654,1150
20,524,"oax","SANTO DOMINGO YODOHINO",122,12,68,1,203,347
20,525,"oax","SANTO DOMINGO ZANATEPEC",1787,666,2285,12,4750,7814
20,526,"oax","SANTO TOMAS JALIEZA",692,265,289,19,1265,2162
20,527,"oax","SANTO TOMAS MAZALTEPEC",230,71,327,5,633,1525
20,528,"oax","SANTO TOMAS OCOTEPEC",147,69,835,4,1055,2497
20,529,"oax","SANTO TOMAS TAMAZULAPAN",191,177,319,9,696,1474
20,530,"oax","SANTOS REYES NOPALA",3592,337,3066,22,7017,10352
20,531,"oax","SANTOS REYES PAPALO",233,215,185,3,636,1506
20,532,"oax","SANTOS REYES TEPEJILLO",65,5,368,0,438,932
20,533,"oax","SANTOS REYES YUCUNA",126,19,79,0,224,629
20,534,"oax","SILACAYOAPAM",975,285,1329,22,2611,5874
20,535,"oax","SITIO DE XITLAPEHUA",97,137,45,1,280,472
20,536,"oax","VILLA SOLA DE VEGA",1389,1258,993,28,3668,8177
20,537,"oax","SOLEDAD ETLA",1071,283,916,49,2319,3502
20,538,"oax","TANICHE",161,88,66,1,316,660
20,539,"oax","VILLA DE TAMAZULAPAM DEL PROGRESO",1286,324,2033,65,3708,4959
20,540,"oax","TAMAZULAPAM DEL ESPIRITU SANTO",364,521,1054,37,1976,4475
20,541,"oax","TANETZE DE ZARAGOZA",192,80,394,4,670,1177
20,542,"oax","TATALTEPEC DE VALDES",465,362,876,11,1714,3222
20,543,"oax","VILLA TEJUPAM DE LA UNION",442,99,420,17,978,1638
20,544,"oax","TEOCOCUILCO DE MARCOS PEREZ",147,102,183,2,434,1048
20,545,"oax","TEOTITLAN DE FLORES MAGON",1696,643,2240,52,4631,6403
20,546,"oax","TEOTITLAN DEL VALLE",433,707,1338,51,2529,4279
20,547,"oax","TEOTONGO",101,38,328,8,475,758
20,548,"oax","TEPELMEME VILLA DE MORELOS",263,49,189,4,505,994
20,549,"oax","TEZOATLAN DE SEGURA Y LUNA",1748,775,1730,65,4318,9250
20,550,"oax","TLACOLULA DE MATAMOROS",2852,1332,4163,194,8541,14674
20,551,"oax","TLACOTEPEC PLUMAS",68,15,91,2,176,332
20,552,"oax","TLALIXTAC DE CABRERA",913,887,1124,75,2999,6168
20,553,"oax","HEROICA CIUDAD DE TLAXIACO",3869,1062,10541,157,15629,26312
20,554,"oax","TOTONTEPEC VILLA DE MORELOS",359,326,826,15,1526,3423
20,555,"oax","TRINIDAD ZAACHILA",383,190,530,23,1126,2189
20,556,"oax","LA TRINIDAD VISTA HERMOSA",60,3,59,2,124,197
20,557,"oax","UNION HIDALGO",2074,1094,2802,70,6040,9914
20,558,"oax","VALERIO TRUJANO",370,69,347,3,789,1186
20,559,"oax","CAPULALPAM DE MENDEZ",165,58,335,11,569,1063
20,560,"oax","VILLA DE ETLA",1792,736,2533,81,5142,6871
20,561,"oax","VILLA DIAZ ORDAZ",947,768,792,38,2545,4352
20,562,"oax","VILLA HIDALGO",170,49,284,1,504,1307
20,563,"oax","YAXE",315,220,330,7,872,1572
20,564,"oax","YOGANA",348,114,104,6,572,1229
20,565,"oax","YUTANDUCHI DE GUERRERO",1,0,0,0,1,809
20,566,"oax","VILLA DE ZAACHILA",4511,1675,5803,262,12251,22255
20,567,"oax","ZAPOTITLAN DEL RIO",338,168,388,4,898,1712
20,568,"oax","ZAPOTITLAN LAGUNAS",488,335,157,11,991,2351
20,569,"oax","ZAPOTITLAN PALMAS",293,48,121,3,465,1225
20,570,"oax","ZIMATLAN DE ALVAREZ",2963,1465,4285,144,8857,14233
21,1,"pue","ACAJETE",8353,4880,7427,419,21079,37609
21,2,"pue","ACATENO",1440,1161,1460,71,4132,6194
21,3,"pue","ACATLAN",6316,2027,6996,274,15613,27665
21,4,"pue","ACATZINGO",8198,2418,6826,297,17739,29138
21,5,"pue","ACTEOPAN",754,430,105,13,1302,2104
21,6,"pue","AHUACATLAN",1817,1236,2439,105,5597,8943
21,7,"pue","AHUATLAN",607,673,151,13,1444,2698
21,8,"pue","AHUAZOTEPEC",1881,396,1493,110,3880,6576
21,9,"pue","AHUEHUETITLA",368,85,502,1,956,1927
21,10,"pue","AJALPAN",9865,5860,4482,993,21200,33813
21,11,"pue","ALBINO ZERTUCHE",397,266,84,16,763,1438
21,12,"pue","ALJOJUCA",1040,1235,618,53,2946,4809
21,13,"pue","ALTEPEXI",2607,2445,2769,92,7913,12013
21,14,"pue","AMIXTLAN",1168,199,630,37,2034,3197
21,15,"pue","AMOZOC",10346,7146,10942,984,29418,51793
21,16,"pue","AQUIXTLA",1891,967,396,54,3308,5266
21,17,"pue","ATEMPAN",4353,1648,2891,171,9063,14739
21,18,"pue","ATEXCAL",958,467,297,46,1768,2538
21,19,"pue","ATLIXCO",15400,17811,18564,1231,53006,94293
21,20,"pue","ATOYATEMPAN",938,433,1481,26,2878,4315
21,21,"pue","ATZALA",373,168,114,6,661,1054
21,22,"pue","ATZITZIHUACAN",1931,1131,1465,49,4576,8391
21,23,"pue","ATZITZINTLA",1688,337,1585,42,3652,5602
21,24,"pue","AXUTLA",146,256,88,5,495,1121
21,25,"pue","AYOTOXCO DE GUERRERO",1644,1256,584,43,3527,5280
21,26,"pue","CALPAN",2214,1072,1859,171,5316,10084
21,27,"pue","CALTEPEC",1213,1165,161,15,2554,3373
21,28,"pue","CAMOCUAUTLA",505,434,207,29,1175,1540
21,29,"pue","CA�ADA MORELOS",3974,1228,1477,113,6792,12215
21,30,"pue","CAXHUACAN",772,98,914,34,1818,2623
21,31,"pue","COATEPEC",279,196,16,2,493,753
21,32,"pue","COATZINGO",732,149,249,6,1136,2354
21,33,"pue","COHETZALA",406,151,55,4,616,1298
21,34,"pue","COHUECAN",802,677,401,43,1923,3256
21,35,"pue","CORONANGO",3705,3539,5459,280,12983,23208
21,36,"pue","COXCATLAN",4214,1218,3214,176,8822,13286
21,37,"pue","COYOMEAPAN",2437,778,1416,248,4879,7272
21,38,"pue","COYOTEPEC",606,236,428,19,1289,1967
21,39,"pue","CUAPIAXTLA DE MADERO",1010,404,1509,44,2967,4735
21,40,"pue","CUAUTEMPAN",2370,710,820,105,4005,6045
21,41,"pue","CUAUTINCHAN",1251,882,1204,164,3501,5425
21,42,"pue","CUAUTLANCINGO",7874,8834,13009,845,30562,50195
21,43,"pue","CUAYUCA DE ANDRADE",837,176,600,1,1614,2823
21,44,"pue","CUETZALAN DEL PROGRESO",6602,4622,5476,463,17163,27614
21,45,"pue","CUYOACO",2851,1974,1553,133,6511,10297
21,46,"pue","CHALCHICOMULA DE SESMA",6874,5529,5997,370,18770,29704
21,47,"pue","CHAPULCO",1467,927,480,19,2893,4224
21,48,"pue","CHIAUTLA",3803,1314,2683,148,7948,15817
21,49,"pue","CHIAUTZINGO",3649,1616,1996,123,7384,13009
21,50,"pue","CHICONCUAUTLA",2400,1816,1296,94,5606,8311
21,51,"pue","CHICHIQUILA",3304,2661,1786,71,7822,12045
21,52,"pue","CHIETLA",6013,2742,5266,321,14342,27742
21,53,"pue","CHIGMECATITLAN",294,204,238,4,740,1038
21,54,"pue","CHIGNAHUAPAN",12109,6805,4811,618,24343,38266
21,55,"pue","CHIGNAUTLA",5336,2984,2712,336,11368,17233
21,56,"pue","CHILA",1102,225,964,34,2325,3921
21,57,"pue","CHILA DE LA SAL",331,206,117,8,662,1411
21,58,"pue","HONEY",1350,1047,541,44,2982,4759
21,59,"pue","CHILCHOTLA",2828,1612,1499,78,6017,10845
21,60,"pue","CHINANTLA",536,414,218,5,1173,2199
21,61,"pue","DOMINGO ARENAS",980,170,957,49,2156,4215
21,62,"pue","ELOXOCHITLAN",3116,1509,461,146,5232,6826
21,63,"pue","EPATLAN",984,796,382,22,2184,3717
21,64,"pue","ESPERANZA",2605,1705,1571,83,5964,9401
21,65,"pue","FRANCISCO Z. MENA",3140,1975,2440,88,7643,11535
21,66,"pue","GENERAL FELIPE ANGELES",2428,1297,2727,98,6550,11502
21,67,"pue","GUADALUPE",1311,751,562,24,2648,5829
21,68,"pue","GUADALUPE VICTORIA",2749,1961,1306,128,6144,10155
21,69,"pue","HERMENEGILDO GALEANA",1092,1276,519,39,2926,4828
21,70,"pue","HUAQUECHULA",4722,3356,2231,225,10534,19692
21,71,"pue","HUATLATLAUCA",1534,589,786,10,2919,5052
21,72,"pue","HUAUCHINANGO",13536,7017,19216,880,40649,62782
21,73,"pue","HUEHUETLA",3281,2259,1636,66,7242,10156
21,74,"pue","HUEHUETLAN EL CHICO",1638,1150,963,61,3812,7394
21,75,"pue","HUEHUETLAN EL GRANDE",1151,849,801,16,2817,4904
21,76,"pue","HUEJOTZINGO",9473,6240,8196,880,24789,43143
21,77,"pue","HUEYAPAN",1433,969,1871,140,4413,6996
21,78,"pue","HUEYTAMALCO",4920,4191,2388,178,11677,17763
21,79,"pue","HUEYTLALPAN",1214,490,691,16,2411,3438
21,80,"pue","HUITZILAN DE SERDAN",2712,1149,855,50,4766,7546
21,81,"pue","HUITZILTEPEC",871,479,1151,31,2532,3643
21,82,"pue","ATLEQUIZAYAN",611,205,366,32,1214,1682
21,83,"pue","IXCAMILPA DE GUERRERO",972,667,147,8,1794,3084
21,84,"pue","IXCAQUIXTLA",1416,394,1500,79,3389,5235
21,85,"pue","IXTACAMAXTITLAN",5184,3227,2307,166,10884,16641
21,86,"pue","IXTEPEC",894,667,967,48,2576,4189
21,87,"pue","IZUCAR DE MATAMOROS",10190,3416,16132,614,30352,55405
21,88,"pue","JALPAN",2361,1324,1781,58,5524,8522
21,89,"pue","JOLALPAN",2249,830,2067,42,5188,9044
21,90,"pue","JONOTLA",982,596,469,54,2101,3233
21,91,"pue","JOPALA",2250,1331,1626,44,5251,8310
21,92,"pue","JUAN C. BONILLA",2072,1745,3654,174,7645,13324
21,93,"pue","JUAN GALINDO",864,267,2826,44,4001,5461
21,94,"pue","JUAN N. MENDEZ",965,530,675,37,2207,3537
21,95,"pue","LAFRAGUA",1620,995,671,13,3299,5573
21,96,"pue","LIBRES",4637,3204,3968,407,12216,19833
21,97,"pue","LA MAGDALENA TLATLAUQUITEPEC",138,135,36,2,311,584
21,98,"pue","MAZAPILTEPEC DE JUAREZ",518,343,245,20,1126,1877
21,99,"pue","MIXTLA",438,126,455,19,1038,1600
21,100,"pue","MOLCAXAC",1128,336,1412,36,2912,4773
21,101,"pue","NAUPAN",1814,883,1052,50,3799,6128
21,102,"pue","NAUZONTLA",917,458,298,34,1707,2497
21,103,"pue","NEALTICAN",1445,1454,1637,118,4654,7546
21,104,"pue","NICOLAS BRAVO",1507,421,658,28,2614,4002
21,105,"pue","NOPALUCAN",3057,2264,2567,177,8065,14161
21,106,"pue","OCOTEPEC",856,643,577,59,2135,3428
21,107,"pue","OCOYUCAN",2987,2058,3488,139,8672,17657
21,108,"pue","OLINTLA",2271,2668,318,28,5285,7386
21,109,"pue","ORIENTAL",2571,1933,1720,146,6370,9982
21,110,"pue","PAHUATLAN",3056,734,3689,106,7585,12287
21,111,"pue","PALMAR DE BRAVO",6148,2888,4810,196,14042,24174
21,112,"pue","PANTEPEC",3529,3281,2046,115,8971,12918
21,113,"pue","PETLALCINGO",1777,639,1409,35,3860,6909
21,114,"pue","PIAXTLA",880,203,981,25,2089,4386
21,115,"pue","PUEBLA",190108,217131,289458,19101,715798,1134837
21,116,"pue","QUECHOLAC",7325,1978,7151,173,16627,26925
21,117,"pue","QUIMIXTLAN",3403,3660,968,44,8075,11582
21,118,"pue","RAFAEL LARA GRAJALES",3217,1770,1824,188,6999,10751
21,119,"pue","LOS REYES DE JUAREZ",2959,763,4081,141,7944,13991
21,120,"pue","SAN ANDRES CHOLULA",9360,16065,15814,1013,42252,67852
21,121,"pue","SAN ANTONIO CA�ADA",982,148,809,37,1976,3127
21,122,"pue","SAN DIEGO LA MESA TOCHIMILTZINGO",311,56,217,4,588,878
21,123,"pue","SAN FELIPE TEOTLALCINGO",1833,698,1031,110,3672,6447
21,124,"pue","SAN FELIPE TEPATLAN",847,260,509,20,1636,2612
21,125,"pue","SAN GABRIEL CHILAC",3279,1031,2247,92,6649,9920
21,126,"pue","SAN GREGORIO ATZOMPA",1054,1359,853,66,3332,5778
21,127,"pue","SAN JERONIMO TECUANIPAN",744,449,722,23,1938,3688
21,128,"pue","SAN JERONIMO XAYACATLAN",1095,134,827,40,2096,3271
21,129,"pue","SAN JOSE CHIAPA",1559,767,812,73,3211,5096
21,130,"pue","SAN JOSE MIAHUATLAN",2204,1176,2509,77,5966,8732
21,131,"pue","SAN JUAN ATENCO",564,613,577,25,1779,2802
21,132,"pue","SAN JUAN ATZOMPA",229,117,116,7,469,1061
21,133,"pue","SAN MARTIN TEXMELUCAN",22379,13676,20946,1820,58821,94995
21,134,"pue","SAN MARTIN TOTOLTEPEC",217,20,144,2,383,625
21,135,"pue","SAN MATIAS TLALANCALECA",3175,1926,2147,216,7464,13011
21,136,"pue","SAN MIGUEL IXITLAN",175,83,46,6,310,485
21,137,"pue","SAN MIGUEL XOXTLA",1675,1596,1419,106,4796,7543
21,138,"pue","SAN NICOLAS BUENOS AIRES",1795,1339,762,50,3946,6360
21,139,"pue","SAN NICOLAS DE LOS RANCHOS",1751,449,1979,47,4226,7544
21,140,"pue","SAN PABLO ANICANO",917,38,812,6,1773,2858
21,141,"pue","SAN PEDRO CHOLULA",13581,17278,21259,1368,53486,84517
21,142,"pue","SAN PEDRO YELOIXTLAHUACA",917,579,341,11,1848,2966
21,143,"pue","SAN SALVADOR EL SECO",4516,1843,5447,296,12102,17668
21,144,"pue","SAN SALVADOR EL VERDE",4713,2212,3342,325,10592,18055
21,145,"pue","SAN SALVADOR HUIXCOLOTLA",1443,625,2588,48,4704,7744
21,146,"pue","SANTA CATARINA TLALTEMPAN",207,175,104,2,488,756
21,147,"pue","SANTA INES AHUATEMPAN",1420,620,607,43,2690,4386
21,148,"pue","SANTA ISABEL CHOLULA",1024,799,1478,79,3380,6771
21,149,"pue","SANTIAGO MIAHUATLAN",3221,1795,2467,143,7626,12442
21,150,"pue","SANTO TOMAS HUEYOTLIPAN",855,462,1997,30,3344,5533
21,151,"pue","SOLTEPEC",1922,1284,1178,70,4454,7987
21,152,"pue","TECALI DE HERRERA",3383,1887,3369,228,8867,13199
21,153,"pue","TECAMACHALCO",7522,4460,15852,481,28315,45323
21,154,"pue","TECOMATLAN",1338,269,471,10,2088,4427
21,155,"pue","TEHUACAN",39455,30628,39188,2458,111729,185472
21,156,"pue","TEHUITZINGO",1929,1108,1579,82,4698,9690
21,157,"pue","TENAMPULCO",1177,1241,747,30,3195,4887
21,158,"pue","TEOPANTLAN",960,729,275,8,1972,3733
21,159,"pue","TEOTLALCO",820,361,284,17,1482,2565
21,160,"pue","TEPANCO DE LOPEZ",3215,1615,2787,206,7823,12867
21,161,"pue","TEPANGO DE RODRIGUEZ",636,461,532,71,1700,2609
21,162,"pue","TEPATLAXCO DE HIDALGO",1866,1387,2827,134,6214,10523
21,163,"pue","TEPEACA",10486,5360,10944,683,27473,46236
21,164,"pue","TEPEMAXALCO",237,105,76,3,421,797
21,165,"pue","TEPEOJUMA",1612,593,1196,37,3438,6567
21,166,"pue","TEPETZINTLA",1537,1126,1003,119,3785,6011
21,167,"pue","TEPEXCO",774,610,1028,28,2440,4528
21,168,"pue","TEPEXI DE RODRIGUEZ",4394,929,2848,193,8364,13199
21,169,"pue","TEPEYAHUALCO",2573,2236,1824,112,6745,10631
21,170,"pue","TEPEYAHUALCO DE CUAUHTEMOC",452,222,979,15,1668,2381
21,171,"pue","TETELA DE OCAMPO",6337,1866,2654,166,11023,17008
21,172,"pue","TETELES DE AVILA CASTILLO",1029,385,1232,71,2717,3976
21,173,"pue","TEZIUTLAN",13708,15736,10413,1371,41228,63364
21,174,"pue","TIANGUISMANALCO",1647,1062,1015,59,3783,7272
21,175,"pue","TILAPA",1573,723,1515,65,3876,6676
21,176,"pue","TLACOTEPEC DE BENITO JUAREZ",6497,4155,6170,195,17017,28412
21,177,"pue","SAN SEBASTIAN TLACOTEPEC",2604,1686,788,109,5187,7354
21,178,"pue","TLACUILOTEPEC",3979,2307,1340,76,7702,10614
21,179,"pue","TLACHICHUCA",4948,2446,3374,242,11010,18268
21,180,"pue","TLAHUAPAN",6091,2364,4293,437,13185,24021
21,181,"pue","TLALTENANGO",736,642,670,61,2109,4115
21,182,"pue","TLANEPANTLA",940,112,847,18,1917,3098
21,183,"pue","TLAOLA",3639,3498,1289,122,8548,12253
21,184,"pue","TLAPACOYA",1372,1321,298,29,3020,4187
21,185,"pue","TLAPANALA",1214,809,1040,29,3092,6129
21,186,"pue","TLATLAUQUITEPEC",8474,4809,6594,562,20439,33847
21,187,"pue","TLAXCO",1325,899,310,26,2560,3578
21,188,"pue","TOCHIMILCO",3061,2292,1126,102,6581,11482
21,189,"pue","TOCHTEPEC",2054,1233,4084,63,7434,12221
21,190,"pue","TOTOLTEPEC DE GUERRERO",277,272,143,5,697,934
21,191,"pue","TULCINGO",1845,714,1325,40,3924,7747
21,192,"pue","TUZAMAPAN DE GALEANA",1084,646,882,48,2660,4069
21,193,"pue","TZICATLACOYAN",1470,1046,385,22,2923,4624
21,194,"pue","VENUSTIANO CARRANZA",4345,2595,4119,261,11320,18960
21,195,"pue","VICENTE GUERRERO",4135,4852,811,76,9874,13726
21,196,"pue","XAYACATLAN DE BRAVO",365,119,378,17,879,1443
21,197,"pue","XICOTEPEC",13025,8421,9530,693,31669,48528
21,198,"pue","XICOTLAN",344,292,15,5,656,1024
21,199,"pue","XIUTETELCO",6400,5527,1960,251,14138,21642
21,200,"pue","XOCHIAPULCO",736,140,495,171,1542,2714
21,201,"pue","XOCHILTEPEC",559,529,268,15,1371,2642
21,202,"pue","XOCHITLAN DE VICENTE SUAREZ",2386,1052,733,118,4289,7380
21,203,"pue","XOCHITLAN TODOS SANTOS",1016,393,844,19,2272,3749
21,204,"pue","YAONAHUAC",1258,280,1711,89,3338,4914
21,205,"pue","YEHUALTEPEC",3579,1911,3131,104,8725,13801
21,206,"pue","ZACAPALA",825,617,368,12,1822,3251
21,207,"pue","ZACAPOAXTLA",8206,3501,7132,714,19553,32897
21,208,"pue","ZACATLAN",15306,6401,9082,1201,31990,50974
21,209,"pue","ZAPOTITLAN",1590,882,1137,121,3730,6165
21,210,"pue","ZAPOTITLAN DE MENDEZ",1045,611,875,32,2563,3645
21,211,"pue","ZARAGOZA",3356,977,2801,157,7291,10435
21,212,"pue","ZAUTLA",3230,595,4192,148,8165,12584
21,213,"pue","ZIHUATEUTLA",2082,1746,1873,74,5775,8392
21,214,"pue","ZINACATEPEC",2663,2163,1897,169,6892,10114
21,215,"pue","ZONGOZOTLA",1071,550,419,58,2098,3106
21,216,"pue","ZOQUIAPAN",517,344,205,32,1098,1713
21,217,"pue","ZOQUITLAN",2548,1125,2926,122,6721,10392
22,1,"que","AMEALCO DE BONFIL",13409,8770,2753,576,25508,40660
22,2,"que","ARROYO SECO",3548,1333,2016,49,6946,10238
22,3,"que","CADEREYTA DE MONTES",13755,8597,4982,586,27920,44141
22,4,"que","COLON",14417,6496,3599,490,25002,36905
22,5,"que","CORREGIDORA",19092,26876,16552,1551,64071,95863
22,6,"que","EZEQUIEL MONTES",8698,5115,3465,326,17604,26153
22,7,"que","HUIMILPAN",6187,5318,1879,403,13787,23323
22,8,"que","JALPAN DE SERRA",6158,3743,2639,159,12699,18366
22,9,"que","LANDA DE MATAMOROS",5523,2683,1107,59,9372,14321
22,10,"que","EL MARQUES",20124,17321,10134,901,48480,71676
22,11,"que","PEDRO ESCOBEDO",14587,7639,6258,1149,29633,42729
22,12,"que","PE�AMILLER",4898,2221,1222,416,8757,12341
22,13,"que","PINAL DE AMOLES",6360,4411,898,85,11754,18013
22,14,"que","QUERETARO",127560,145709,100214,9055,382538,590162
22,15,"que","SAN JOAQUIN",2341,1169,427,29,3966,5933
22,16,"que","SAN JUAN DEL RIO",44621,29097,25076,3335,102129,167342
22,17,"que","TEQUISQUIAPAN",15340,8845,7173,1038,32396,44434
22,18,"que","TOLIMAN",5254,3771,2815,156,11996,17615
23,1,"qui","BENITO JUAREZ",67617,59622,108714,5232,241185,452760
23,2,"qui","COZUMEL",14303,10723,11566,576,37168,59440
23,8,"qui","SOLIDARIDAD",23025,10623,36602,1174,71424,139770
23,3,"qui","FELIPE CARRILLO PUERTO",16202,2374,12610,432,31618,45189
23,4,"qui","ISLA MUJERES",3905,3128,2511,109,9653,15362
23,5,"qui","JOSE MARIA MORELOS",7306,2433,5715,159,15613,22457
23,6,"qui","LAZARO CARDENAS",6952,3407,2796,137,13292,17221
23,7,"qui","OTHON P. BLANCO",39954,18990,45663,2548,107155,172890
24,1,"san","AHUALULCO",3262,3129,1613,154,8158,12839
24,2,"san","ALAQUINES",1878,1490,668,21,4057,5980
24,3,"san","AQUISMON",5116,8182,5716,89,19103,27196
24,4,"san","ARMADILLO DE LOS INFANTE",1310,824,448,36,2618,3594
24,5,"san","CARDENAS",3703,2880,1895,216,8694,13945
24,6,"san","CATORCE",2400,1440,912,42,4794,6530
24,7,"san","CEDRAL",3982,1500,1883,204,7569,12665
24,8,"san","CERRITOS",4471,3809,1970,175,10425,15994
24,9,"san","CERRO DE SAN PEDRO",1200,818,443,38,2499,3114
24,10,"san","CIUDAD DEL MAIZ",7433,4927,991,167,13518,21569
24,57,"san","EL NARANJO",3262,3027,2195,96,8580,13549
24,11,"san","CIUDAD FERNANDEZ",7739,5650,4953,484,18826,31639
24,12,"san","TANCANHUITZ",4162,2032,2679,102,8975,12913
24,13,"san","CIUDAD VALLES",27748,19422,17708,1774,66652,116893
24,14,"san","COXCATLAN",3422,1768,2241,58,7489,11159
24,15,"san","CHARCAS",5174,2144,1660,127,9105,14399
24,16,"san","EBANO",5904,4346,6236,236,16722,28238
24,17,"san","GUADALCAZAR",6350,4421,774,77,11622,17713
24,18,"san","HUEHUETLAN",3497,2237,1153,91,6978,9724
24,19,"san","LAGUNILLAS",1495,931,660,19,3105,4848
24,20,"san","MATEHUALA",16855,10874,8014,933,36676,65123
24,21,"san","MEXQUITIC DE CARMONA",10929,6176,6235,465,23805,36679
24,22,"san","MOCTEZUMA",4196,2272,1525,184,8177,13402
24,23,"san","RAYON",3354,2355,997,529,7235,12163
24,24,"san","RIOVERDE",18099,14777,6786,975,40637,70576
24,25,"san","SALINAS",5150,3313,3010,309,11782,19826
24,26,"san","SAN ANTONIO",2267,1713,858,39,4877,6118
24,27,"san","SAN CIRO DE ACOSTA",2511,2001,719,38,5269,8375
24,28,"san","SAN LUIS POTOSI",99546,121315,88615,12639,322115,551604
24,29,"san","SAN MARTIN CHALCHICUAUTLA",3894,3234,3404,74,10606,14656
24,30,"san","SAN NICOLAS TOLENTINO",1249,1050,584,213,3096,5091
24,31,"san","SAN VICENTE TANCUAYALAB",3698,2108,1570,87,7463,9810
24,32,"san","SANTA CATARINA",2399,488,1455,62,4404,7073
24,33,"san","SANTA MARIA DEL RIO",7799,6271,2203,288,16561,27002
24,34,"san","SANTO DOMINGO",3129,1828,1099,184,6240,9391
24,35,"san","SOLEDAD DE GRACIANO SANCHEZ",30672,26755,27713,4201,89341,158857
24,36,"san","TAMASOPO",6311,2326,4505,242,13384,20080
24,37,"san","TAMAZUNCHALE",16806,6495,9786,3012,36099,61786
24,58,"san","MATLAPA",6751,3775,2754,116,13396,19103
24,38,"san","TAMPACAN",3178,1855,3016,118,8167,10805
24,39,"san","TAMPAMOLON CORONA",2566,1998,1487,79,6130,9118
24,40,"san","TAMUIN",5950,5123,3478,401,14952,24800
24,41,"san","TANLAJAS",3373,1265,4009,183,8830,11839
24,42,"san","TANQUIAN DE ESCOBEDO",2947,2868,1057,84,6956,9574
24,43,"san","TIERRA NUEVA",1983,1677,455,228,4343,6849
24,44,"san","VANEGAS",2137,1146,114,17,3414,5124
24,45,"san","VENADO",3036,2349,1358,86,6829,10129
24,46,"san","VILLA DE ARISTA",4121,2480,605,49,7255,10117
24,47,"san","VILLA DE ARRIAGA",4532,2290,876,286,7984,10793
24,48,"san","VILLA DE GUADALUPE",2391,1326,651,64,4432,7305
24,49,"san","VILLA DE LA PAZ",1146,738,540,40,2464,3741
24,50,"san","VILLA DE RAMOS",7810,5171,3454,291,16726,24841
24,51,"san","VILLA DE REYES",9700,6719,3317,664,20400,29769
24,52,"san","VILLA HIDALGO",4111,2254,884,89,7338,11212
24,53,"san","VILLA JUAREZ",2033,1881,1065,49,5028,8639
24,54,"san","AXTLA DE TERRAZAS",5179,3499,5322,702,14702,21413
24,55,"san","XILITLA",10941,7299,3177,151,21568,32300
24,56,"san","ZARAGOZA",5000,2701,2123,204,10028,15605
25,1,"sin","AHOME",69805,51670,44617,3233,169325,276898
25,2,"sin","ANGOSTURA",13340,3508,6397,358,23603,33938
25,3,"sin","BADIRAGUATO",10218,1347,622,157,12344,20867
25,4,"sin","CONCORDIA",6556,4340,1473,250,12619,20033
25,5,"sin","COSALA",4302,1740,583,105,6730,11408
25,6,"sin","CULIACAN",169334,74188,93609,7555,344686,596800
25,7,"sin","CHOIX",6928,6415,848,128,14319,22605
25,8,"sin","ELOTA",9383,4904,1888,356,16531,25807
25,9,"sin","ESCUINAPA",11198,7803,4368,610,23979,36270
25,10,"sin","EL FUERTE",19514,14434,8472,650,43070,68564
25,11,"sin","GUASAVE",62588,22325,35529,2654,123096,191401
25,12,"sin","MAZATLAN",76016,47144,47444,3447,174051,308764
25,13,"sin","MOCORITO",13185,4564,3554,399,21702,34767
25,14,"sin","ROSARIO",9946,5773,5227,633,21579,34813
25,15,"sin","SALVADOR ALVARADO",19223,8487,8231,687,36628,57033
25,16,"sin","SAN IGNACIO",4912,3138,897,182,9129,16389
25,17,"sin","SINALOA",17175,16161,5824,307,39467,62613
25,18,"sin","NAVOLATO",28540,18380,9674,907,57501,93318
26,1,"son","ACONCHI",754,681,172,11,1618,2223
26,2,"son","AGUA PRIETA",17221,7897,5056,523,30697,58312
26,3,"son","ALTAR",1802,1460,831,24,4117,5836
26,4,"son","ARIVECHI",453,340,134,27,954,1240
26,5,"son","ARIZPE",944,929,78,15,1966,2713
26,6,"son","ATIL",273,352,14,1,640,819
26,7,"son","BACADEHUACHI",298,270,275,11,854,1045
26,8,"son","BACANORA",325,493,129,21,968,1890
26,9,"son","BACERAC",368,278,222,5,873,1104
26,10,"son","BACOACHI",513,237,234,4,988,1355
26,11,"son","BANAMICHI",504,425,92,14,1035,1288
26,12,"son","BAVIACORA",1225,922,156,18,2321,2974
26,13,"son","BAVISPE",646,322,70,9,1047,1354
26,14,"son","BENJAMIN HILL",900,1135,466,12,2513,3929
26,15,"son","CANANEA",5116,4699,4636,306,14757,25355
26,16,"son","CUCURPE",360,348,29,3,740,978
26,17,"son","CUMPAS",1770,1592,332,31,3725,5192
26,18,"son","DIVISADEROS",308,280,163,49,800,1040
26,19,"son","FRONTERAS",2040,1220,754,52,4066,5851
26,20,"son","GRANADOS",492,440,74,4,1010,1260
26,21,"son","HUACHINERA",468,212,120,6,806,978
26,22,"son","HUASABAS",533,444,41,7,1025,1202
26,23,"son","HUEPAC",426,463,81,15,985,1241
26,24,"son","IMURIS",2715,1267,1113,52,5147,8568
26,25,"son","MAGDALENA",5825,5074,1737,243,12879,22207
26,26,"son","MOCTEZUMA",1491,1052,307,40,2890,3895
26,27,"son","NACO",1559,872,788,30,3249,4406
26,28,"son","NACORI CHICO",558,491,57,37,1143,1469
26,29,"son","NACOZARI DE GARCIA",2435,1934,1202,65,5636,9446
26,30,"son","NOGALES",36720,26112,15749,1384,79965,167372
26,31,"son","OQUITOA",230,156,23,4,413,472
26,32,"son","SAHUARIPA",1379,1031,391,61,2862,4452
26,33,"son","SAN FELIPE DE JESUS",178,161,43,5,387,474
26,34,"son","SAN JAVIER",268,155,95,9,527,734
26,35,"son","SAN PEDRO DE LA CUEVA",785,674,107,11,1577,2117
26,36,"son","SANTA ANA",3499,3396,1146,87,8128,11633
26,37,"son","SANTA CRUZ",495,180,157,4,836,1283
26,38,"son","SARIC",680,561,26,0,1267,2011
26,39,"son","SOYOPA",765,576,318,18,1677,2219
26,40,"son","SUAQUI GRANDE",574,454,78,10,1116,1353
26,41,"son","TEPACHE",459,220,292,20,991,1526
26,42,"son","TRINCHERAS",575,510,48,7,1140,1461
26,43,"son","TUBUTAMA",527,395,85,3,1010,1408
26,44,"son","VILLA HIDALGO",515,551,66,9,1141,1534
26,45,"son","VILLA PESQUEIRA",703,491,126,11,1331,1598
26,46,"son","CABORCA",13099,10636,5102,599,29436,54944
26,47,"son","CARBO",767,676,446,157,2046,3383
26,48,"son","LA COLORADA",734,569,407,12,1722,2293
26,49,"son","HERMOSILLO",105058,113309,65787,5463,289617,511897
26,50,"son","MAZATAN",552,327,348,19,1246,1481
26,51,"son","OPODEPE",784,662,63,9,1518,2109
26,52,"son","PITIQUITO",2005,1479,420,48,3952,5775
26,53,"son","PUERTO PE�ASCO",10687,6972,3646,342,21647,41208
26,54,"son","RAYON",738,711,135,22,1606,2126
26,55,"son","SAN LUIS RIO COLORADO",26948,25736,12429,1118,66231,134392
26,56,"son","SAN MIGUEL DE HORCASITAS",1002,1213,210,16,2441,4406
26,57,"son","URES",2192,1827,969,206,5194,7971
26,58,"son","BACUM",3992,1358,4363,92,9805,16846
26,59,"son","CAJEME",71006,34741,56139,2102,163988,291588
26,60,"son","EMPALME",6378,5068,10416,326,22188,38373
26,61,"son","GUAYMAS",19161,15412,23245,879,58697,103895
26,72,"son","SAN IGNACIO RIO MUERTO",3110,786,2052,33,5981,9628
26,62,"son","ALAMOS",5664,3312,2570,84,11630,17643
26,63,"son","ETCHOJOA",8754,7879,9967,271,26871,40064
26,71,"son","BENITO JUAREZ",3350,1614,3693,175,8832,14621
26,64,"son","HUATABAMPO",14722,12781,10604,258,38365,55363
26,65,"son","NAVOJOA",25875,24151,16256,726,67008,109053
26,66,"son","ONAVAS",353,126,144,10,633,783
26,67,"son","QUIRIEGO",1224,792,452,5,2473,3310
26,68,"son","ROSARIO",1601,832,417,6,2856,4592
26,69,"son","YECORA",1914,815,171,18,2918,4047
26,70,"son","GENERAL PLUTARCO ELIAS CALLES",3436,1263,1382,51,6132,9714
27,1,"tab","BALANCAN",11453,5533,10992,120,28098,38870
27,2,"tab","CARDENAS",34314,4014,66009,477,104814,161382
27,3,"tab","CENTLA",14269,6858,25648,204,46979,65030
27,4,"tab","CENTRO",84782,15874,207340,2067,310063,462801
27,5,"tab","COMALCALCO",32753,3191,60542,486,96972,131186
27,6,"tab","CUNDUACAN",20224,2658,34870,375,58127,82320
27,7,"tab","EMILIANO ZAPATA",5933,2412,7134,50,15529,21518
27,8,"tab","HUIMANGUILLO",30409,3361,45500,498,79768,116432
27,9,"tab","JALAPA",8509,937,10323,68,19837,25950
27,10,"tab","JALPA DE MENDEZ",10931,4932,26359,198,42420,55575
27,11,"tab","JONUTA",8058,859,8484,18,17419,21195
27,12,"tab","MACUSPANA",21847,3995,45376,346,71564,106975
27,13,"tab","NACAJUCA",14224,1756,37105,305,53390,74274
27,14,"tab","PARAISO",18920,2696,23816,177,45609,60050
27,15,"tab","TACOTALPA",7698,2374,12219,90,22381,29811
27,16,"tab","TEAPA",9045,1484,13245,155,23929,36865
27,17,"tab","TENOSIQUE",13163,2106,12060,134,27463,39908
28,1,"tam","ABASOLO",2452,2198,795,43,5488,8653
28,2,"tam","ALDAMA",5723,8040,2309,148,16220,22813
28,3,"tam","ALTAMIRA",25319,37348,14556,1661,78884,131808
28,4,"tam","ANTIGUO MORELOS",2121,2112,376,50,4659,6945
28,5,"tam","BURGOS",1376,1082,197,13,2668,4264
28,6,"tam","BUSTAMANTE",2286,1436,118,8,3848,5422
28,7,"tam","CAMARGO",3091,2225,868,162,6346,12748
28,8,"tam","CASAS",1522,939,189,14,2664,3775
28,9,"tam","CIUDAD MADERO",26543,40881,29838,2152,99414,158864
28,10,"tam","CRUILLAS",802,379,63,13,1257,2283
28,11,"tam","GOMEZ FARIAS",2120,2218,487,45,4870,6808
28,12,"tam","GONZALEZ",7911,9532,1967,270,19680,30887
28,13,"tam","GUEMEZ",5060,2474,868,82,8484,12068
28,14,"tam","GUERRERO",546,545,70,19,1180,2816
28,15,"tam","GUSTAVO DIAZ ORDAZ",3207,3120,961,149,7437,13331
28,16,"tam","HIDALGO",3254,2813,3768,83,9918,17014
28,17,"tam","JAUMAVE",3723,1928,1691,81,7423,10512
28,18,"tam","JIMENEZ",2362,1363,255,102,4082,6561
28,19,"tam","LLERA",3750,3249,984,91,8074,13258
28,20,"tam","MAINERO",907,598,73,2,1580,2316
28,21,"tam","EL MANTE",20964,24100,10365,1046,56475,88766
28,22,"tam","MATAMOROS",73854,77022,37870,4493,193239,371430
28,23,"tam","MENDEZ",1350,1064,370,14,2798,4022
28,24,"tam","MIER",745,1084,191,32,2052,4858
28,25,"tam","MIGUEL ALEMAN",4847,4779,1243,259,11128,19747
28,26,"tam","MIQUIHUANA",1130,527,127,10,1794,2615
28,27,"tam","NUEVO LAREDO",44592,78090,23198,4798,150678,288023
28,28,"tam","NUEVO MORELOS",812,887,187,8,1894,2711
28,29,"tam","OCAMPO",2821,3439,487,87,6834,10246
28,30,"tam","PADILLA",3154,3502,734,87,7477,11141
28,31,"tam","PALMILLAS",613,299,62,12,986,1452
28,32,"tam","REYNOSA",76912,96845,55819,5306,234882,455470
28,33,"tam","RIO BRAVO",18014,22679,11051,1157,52901,95867
28,34,"tam","SAN CARLOS",2568,1897,489,29,4983,7575
28,35,"tam","SAN FERNANDO",10452,10768,4202,392,25814,41142
28,36,"tam","SAN NICOLAS",540,132,28,2,702,1044
28,37,"tam","SOTO LA MARINA",5627,4896,1340,205,12068,18269
28,38,"tam","TAMPICO",41778,74995,31922,3151,151846,239106
28,39,"tam","TULA",7022,3995,997,139,12153,19637
28,40,"tam","VALLE HERMOSO",10918,11364,4269,688,27239,48025
28,41,"tam","VICTORIA",54302,47276,34961,4279,140818,218030
28,42,"tam","VILLAGRAN",2114,878,331,28,3351,5124
28,43,"tam","XICOTENCATL",5053,5225,1491,219,11988,17600
29,1,"tla","AMAXAC DE GUERRERO",1685,619,2226,121,4651,6844
29,2,"tla","APETATITLAN DE ANTONIO CARVAJAL",2416,1361,2954,234,6965,10137
29,3,"tla","APIZACO",13752,6808,14217,1485,36262,59493
29,4,"tla","ATLANGATEPEC",1441,547,778,64,2830,4413
29,34,"tla","TLAXCO",8339,3268,4520,493,16620,27500
29,5,"tla","ALTZAYANCA",3245,2076,1897,202,7420,10839
29,6,"tla","CALPULALPAN",7516,4324,6973,503,19316,29938
29,7,"tla","EL CARMEN TEQUEXQUITLA",2398,1679,1368,197,5642,9924
29,8,"tla","CUAPIAXTLA",2250,1411,1933,189,5783,8895
29,9,"tla","CUAXOMULCO",1191,687,688,84,2650,3860
29,10,"tla","CHIAUTEMPAN",9509,5751,13900,935,30095,47274
29,52,"tla","LA MAGDALENA TLALTELULCO",2382,1712,3318,158,7570,12007
29,51,"tla","SAN FRANCISCO TETLANOHCAN",1705,810,2235,87,4837,7411
29,11,"tla","MU�OZ DE DOMINGO ARENAS",870,417,814,56,2157,3307
29,12,"tla","ESPA�ITA",1387,771,1311,117,3586,5836
29,13,"tla","HUAMANTLA",11689,9122,10769,1312,32892,54016
29,14,"tla","HUEYOTLIPAN",2279,1380,2179,181,6019,10440
29,15,"tla","IXTACUIXTLA DE MARIANO MATAMOROS",5737,2685,6182,644,15248,25667
29,58,"tla","SANTA ANA NOPALUCAN",1011,371,1133,67,2582,4886
29,16,"tla","IXTENCO",842,609,1544,88,3083,4812
29,17,"tla","MAZATECOCHCO DE JOSE MARIA MORELOS",1291,684,2139,80,4194,6560
29,18,"tla","CONTLA DE JUAN CUAMATZI",4766,2268,7908,469,15411,23511
29,19,"tla","TEPETITLA DE LARDIZABAL",2731,1540,3196,214,7681,12700
29,20,"tla","SANCTORUM DE LAZARO CARDENAS",1456,1069,1159,123,3807,5865
29,60,"tla","BENITO JUAREZ",1024,400,907,48,2379,3728
29,21,"tla","NANACAMILPA DE MARIANO ARISTA",2657,1806,2508,233,7204,11849
29,22,"tla","ACUAMANALA DE MIGUEL HIDALGO",823,503,1438,38,2802,3945
29,46,"tla","SANTA CRUZ QUILEHTLA",618,257,1392,30,2297,4074
29,45,"tla","SANTA APOLONIA TEACALCO",651,174,1114,42,1981,3295
29,23,"tla","NATIVITAS",3088,1943,4288,329,9648,16785
29,24,"tla","PANOTLA",4679,1546,5479,440,12144,18951
29,25,"tla","SAN PABLO DEL MONTE",8969,7850,11546,522,28887,44589
29,26,"tla","SANTA CRUZ TLAXCALA",3150,1558,2797,242,7747,11576
29,27,"tla","TENANCINGO",1443,661,2200,75,4379,8085
29,28,"tla","TEOLOCHOLCO",3433,1464,4396,220,9513,14877
29,29,"tla","TEPEYANCO",1707,632,2387,139,4865,7857
29,49,"tla","SANTA ISABEL XILOXOXTLA",573,207,681,39,1500,2843
29,47,"tla","SAN JUAN HUACTZINCO",652,213,1262,51,2178,4669
29,30,"tla","TERRENATE",2639,1076,1540,131,5386,9071
29,54,"tla","EMILIANO ZAPATA",1071,446,399,34,1950,2800
29,55,"tla","LAZARO CARDENAS",441,341,441,46,1269,1960
29,31,"tla","TETLA DE LA SOLIDARIDAD",4417,2110,3823,439,10789,18348
29,32,"tla","TETLATLAHUCA",1861,855,2245,177,5138,8732
29,53,"tla","SAN DAMIAN TEXOLOC",802,377,1173,98,2450,3781
29,56,"tla","SAN JERONIMO ZACUALPAN",653,199,734,197,1783,2774
29,33,"tla","TLAXCALA",15635,6978,20675,1729,45017,65473
29,35,"tla","TOCATLAN",846,617,830,84,2377,3897
29,36,"tla","TOTOLAC",3579,1176,4685,385,9825,14781
29,37,"tla","ZITLALTEPEC DE TRINIDAD SANCHEZ SANTOS",1616,863,1188,92,3759,6322
29,38,"tla","TZOMPANTEPEC",2198,949,2048,161,5356,9097
29,50,"tla","SAN JOSE TEACALCO",1121,392,986,56,2555,3824
29,39,"tla","XALOZTOC",3438,1352,3188,246,8224,14460
29,40,"tla","XALTOCAN",1727,853,1839,143,4562,7249
29,57,"tla","SAN LUCAS TECOPILCO",510,235,616,23,1384,2299
29,41,"tla","PAPALOTLA DE XICOHTENCATL",3553,1751,6176,191,11671,18409
29,42,"tla","XICOHTZINCO",1519,973,3028,145,5665,9336
29,43,"tla","YAUHQUEMECAN",4665,2179,4438,461,11743,19376
29,59,"tla","SAN LORENZO AXOCOMANITLA",690,296,1099,74,2159,3269
29,44,"tla","ZACATELCO",5387,2988,9658,422,18455,28735
29,48,"tla","SANTA CATARINA AYOMETLA",1119,536,2140,97,3892,6357
30,1,"ver","ACAJETE",1229,1484,1117,54,3884,5615
30,2,"ver","ACATLAN",712,643,333,5,1693,2127
30,3,"ver","ACAYUCAN",12850,11329,12249,445,36873,58930
30,4,"ver","ACTOPAN",6733,8581,5584,227,21125,31265
30,5,"ver","ACULA",1105,1480,321,17,2923,4118
30,6,"ver","ACULTZINGO",2817,1390,3459,119,7785,12334
30,7,"ver","CAMARON DE TEJEDA",1424,1806,362,30,3622,4693
30,8,"ver","ALAMO TEMAPACHE",20020,15674,10377,812,46883,70373
30,9,"ver","ALPATLAHUAC",1538,1942,394,35,3909,5661
30,10,"ver","ALTO LUCERO DE GUTIERREZ BARRIOS",4568,5397,4655,166,14786,21053
30,11,"ver","ALTOTONGA",10001,6158,6466,504,23129,34798
30,12,"ver","ALVARADO",9518,11741,3740,435,25434,38477
30,13,"ver","AMATITLAN",1448,2174,602,54,4278,6064
30,14,"ver","AMATLAN DE LOS REYES",6194,7870,5434,214,19712,28785
30,15,"ver","NARANJOS AMATLAN",5712,4250,3142,194,13298,18423
30,16,"ver","ANGEL R. CABADA",5116,6177,4233,180,15706,25012
30,17,"ver","LA ANTIGUA",4457,6638,3456,241,14792,22030
30,18,"ver","APAZAPAN",995,811,520,41,2367,3184
30,19,"ver","AQUILA",503,352,71,3,929,1360
30,20,"ver","ASTACINGA",895,1173,603,13,2684,3923
30,21,"ver","ATLAHUILCO",1341,1198,1924,53,4516,5739
30,22,"ver","ATOYAC",4084,3768,3136,124,11112,16766
30,23,"ver","ATZACAN",3613,2842,2710,163,9328,12637
30,24,"ver","ATZALAN",10332,8975,2726,202,22235,32149
30,25,"ver","TLALTETELA",3058,3918,653,46,7675,9786
30,26,"ver","AYAHUALULCO",3684,3952,1204,81,8921,14277
30,27,"ver","BANDERILLA",2798,2816,4575,210,10399,14980
30,28,"ver","BENITO JUAREZ",3183,2579,1352,34,7148,10181
30,29,"ver","BOCA DEL RIO",23395,38813,17757,943,80908,119056
30,30,"ver","CALCAHUALCO",1870,2000,1009,51,4930,7152
30,31,"ver","CAMERINO Z. MENDOZA",5127,3285,7255,312,15979,22462
30,32,"ver","CARRILLO PUERTO",3013,3205,1939,107,8264,11508
30,33,"ver","CASTILLO DE TEAYO",3758,3594,1902,191,9445,13487
30,34,"ver","CATEMACO",7598,6788,6207,241,20834,31739
30,35,"ver","CAZONES DE HERRERA",5092,4929,1308,80,11409,16421
30,36,"ver","CERRO AZUL",4554,3338,3529,222,11643,17485
30,37,"ver","CITLALTEPETL",2455,2426,371,22,5274,7130
30,38,"ver","COACOATZINTLA",1105,1852,959,39,3955,6103
30,39,"ver","COAHUITLAN",1377,1226,595,82,3280,4642
30,40,"ver","COATEPEC",11356,11844,17211,1035,41446,60866
30,41,"ver","COATZACOALCOS",43752,26998,70067,1940,142757,224229
30,42,"ver","COATZINTLA",7527,5473,6550,478,20028,33776
30,43,"ver","COETZALA",522,263,342,5,1132,1434
30,44,"ver","COLIPA",1398,921,657,15,2991,4356
30,45,"ver","COMAPA",3685,4628,692,57,9062,12830
30,46,"ver","CORDOBA",26418,39786,28296,1389,95889,142071
30,47,"ver","COSAMALOAPAN",9691,7740,8866,535,26832,44188
30,208,"ver","CARLOS A. CARRILLO",3745,3801,2565,180,10291,16907
30,48,"ver","COSAUTLAN DE CARVAJAL",2091,3590,1420,154,7255,10484
30,49,"ver","COSCOMATEPEC",7597,6885,3707,265,18454,29960
30,50,"ver","COSOLEACAQUE",16248,8328,25159,573,50308,79246
30,51,"ver","COTAXTLA",3767,4513,2429,99,10808,14748
30,52,"ver","COXQUIHUI",3294,2949,842,40,7125,9956
30,53,"ver","COYUTLA",4542,2683,2703,76,10004,14421
30,54,"ver","CUICHAPA",2245,1683,1793,72,5793,8594
30,55,"ver","CUITLAHUAC",4859,4376,3556,148,12939,19589
30,56,"ver","CHACALTIANGUIS",3149,1778,1303,72,6302,9166
30,57,"ver","CHALMA",2518,1617,2130,96,6361,9126
30,58,"ver","CHICONAMEL",1114,1244,745,21,3124,4599
30,59,"ver","CHICONQUIACO",1836,3302,950,30,6118,8516
30,60,"ver","CHICONTEPEC",10535,7633,6464,298,24930,37272
30,61,"ver","CHINAMECA",3613,1273,3138,66,8090,12630
30,62,"ver","CHINAMPA DE GOROSTIZA",2945,2770,746,47,6508,9263
30,63,"ver","LAS CHOAPAS",9735,8480,10277,296,28788,52229
30,64,"ver","CHOCAMAN",3512,3027,2043,138,8720,12138
30,65,"ver","CHONTLA",3588,3100,481,34,7203,9370
30,66,"ver","CHUMATLAN",655,951,343,10,1959,2636
30,67,"ver","EMILIANO ZAPATA",9151,7866,9631,501,27149,39764
30,68,"ver","ESPINAL",5293,3658,2399,93,11443,17453
30,69,"ver","FILOMENO MATA",2543,2465,943,29,5980,7444
30,70,"ver","FORTIN",7617,12754,8983,543,29897,42710
30,71,"ver","GUTIERREZ ZAMORA",4677,2487,3455,242,10861,16898
30,72,"ver","HIDALGOTITLAN",2676,4358,1388,52,8474,12485
30,209,"ver","UXPANAPA",4235,5434,1687,93,11449,17129
30,73,"ver","HUATUSCO",7199,11316,5977,484,24976,35953
30,74,"ver","HUAYACOCOTLA",4871,1848,2131,86,8936,12250
30,75,"ver","HUEYAPAN DE OCAMPO",6406,5218,4963,145,16732,28016
30,76,"ver","HUILOAPAN DE CUAUHTEMOC",1025,1125,1010,67,3227,4700
30,77,"ver","IGNACIO DE LA LLAVE",3765,3397,885,69,8116,12432
30,78,"ver","ILAMATLAN",1831,2185,1752,70,5838,7894
30,79,"ver","ISLA",6557,7095,2817,135,16604,27611
30,80,"ver","IXCATEPEC",2745,2852,510,202,6309,8530
30,81,"ver","IXHUACAN DE LOS REYES",2050,2259,487,37,4833,6924
30,82,"ver","IXHUATLAN DE MADERO",9105,5616,5773,190,20684,30777
30,83,"ver","IXHUATLAN DEL CAFE",2995,4102,2199,172,9468,14055
30,84,"ver","IXHUATLAN DEL SURESTE",2859,1033,3417,50,7359,11274
30,85,"ver","IXHUATLANCILLO",1978,2244,2880,142,7244,12398
30,86,"ver","IXMATLAHUACAN",1226,1690,488,58,3462,5055
30,87,"ver","IXTACZOQUITLAN",9098,9567,9891,481,29037,42109
30,88,"ver","JALACINGO",5353,4958,2906,540,13757,22334
30,89,"ver","XALAPA",55451,55449,108700,4935,224535,336047
30,90,"ver","JALCOMULCO",786,827,975,15,2603,3956
30,91,"ver","JALTIPAN",7044,5269,7638,191,20142,29069
30,92,"ver","JAMAPA",2014,2741,608,42,5405,7841
30,93,"ver","JESUS CARRANZA",4028,4036,2763,102,10929,18665
30,94,"ver","JILOTEPEC",2930,1969,1956,84,6939,10183
30,95,"ver","JUAN RODRIGUEZ CLARA",7601,6183,2224,99,16107,24889
30,96,"ver","JUCHIQUE DE FERRER",2645,3174,1743,56,7618,12214
30,97,"ver","LANDERO Y COSS",433,445,170,6,1054,1723
30,98,"ver","LERDO DE TEJADA",3610,3494,2237,95,9436,15043
30,99,"ver","MAGDALENA",524,340,418,4,1286,1657
30,100,"ver","MALTRATA",1899,2460,1624,102,6085,10450
30,101,"ver","MANLIO FABIO ALTAMIRANO",3241,5713,2175,100,11229,16645
30,102,"ver","MARIANO ESCOBEDO",4661,3204,5287,221,13373,21189
30,103,"ver","MARTINEZ DE LA TORRE",14917,13860,13612,1072,43461,72257
30,211,"ver","SAN RAFAEL",5624,5625,2888,225,14362,21841
30,104,"ver","MECATLAN",1915,1791,742,19,4467,6329
30,105,"ver","MECAYAPAN",3922,1336,2897,47,8202,11509
30,210,"ver","TATAHUICAPAN DE JUAREZ",3522,778,2679,43,7022,9501
30,106,"ver","MEDELLIN",6083,11764,4556,328,22731,37999
30,107,"ver","MIAHUATLAN",740,549,863,15,2167,2947
30,108,"ver","LAS MINAS",552,343,226,8,1129,1807
30,109,"ver","MINATITLAN",27835,14938,34308,955,78036,119498
30,110,"ver","MISANTLA",11349,9256,8358,450,29413,44980
30,111,"ver","MIXTLA DE ALTAMIRANO",2036,1905,215,34,4190,5783
30,112,"ver","MOLOACAN",3582,1204,2879,48,7713,12222
30,113,"ver","NAOLINCO",3642,3578,3073,114,10407,13919
30,114,"ver","NARANJAL",796,873,551,25,2245,2987
30,115,"ver","NAUTLA",2153,1250,1463,74,4940,7561
30,116,"ver","NOGALES",5809,6168,7989,385,20351,31956
30,117,"ver","OLUTA",2448,2466,2038,50,7002,10926
30,118,"ver","OMEALCA",4344,3499,2997,111,10951,16178
30,119,"ver","ORIZABA",16085,20862,26273,1288,64508,93988
30,120,"ver","OTATITLAN",1093,735,906,35,2769,4405
30,121,"ver","OTEAPAN",2598,1013,2363,35,6009,8657
30,122,"ver","OZULUAMA",4995,5410,532,71,11008,15573
30,123,"ver","PAJAPAN",2878,2355,2236,50,7519,10561
30,124,"ver","PANUCO",17559,14065,7765,665,40054,66414
30,125,"ver","PAPANTLA",21376,20534,25531,1247,68688,110597
30,126,"ver","PASO DEL MACHO",5153,4759,4746,148,14806,20814
30,127,"ver","PASO DE OVEJAS",4846,7205,3460,216,15727,24262
30,128,"ver","LA PERLA",3579,3725,995,89,8388,11795
30,129,"ver","PEROTE",10473,8012,7238,545,26268,40991
30,130,"ver","PLATON SANCHEZ",4047,3188,1311,61,8607,11997
30,131,"ver","PLAYA VICENTE",7616,6266,4364,136,18382,27981
30,212,"ver","SANTIAGO SOCHIAPAN",2114,2156,1210,46,5526,8840
30,132,"ver","POZA RICA DE HIDALGO",31473,27413,27044,1801,87731,139396
30,133,"ver","PUEBLO VIEJO",6933,9372,3644,253,20202,33721
30,134,"ver","PUENTE NACIONAL",2911,4637,2849,113,10510,15855
30,135,"ver","RAFAEL DELGADO",2831,3148,2402,102,8483,11622
30,136,"ver","RAFAEL LUCIO",1155,1321,1097,45,3618,4894
30,137,"ver","LAS VIGAS DE RAMIREZ",2247,2626,2135,160,7168,11007
30,138,"ver","LOS REYES",1116,850,314,17,2297,3108
30,139,"ver","RIO BLANCO",5738,5966,8579,394,20677,31704
30,140,"ver","SALTABARRANCA",1504,1120,581,25,3230,4756
30,141,"ver","SAN ANDRES TENEJAPAN",530,501,246,6,1283,1670
30,142,"ver","SAN ANDRES TUXTLA",23327,18333,17741,746,60147,105819
30,143,"ver","SAN JUAN EVANGELISTA",5149,6550,2715,132,14546,23171
30,144,"ver","SANTIAGO TUXTLA",9032,10232,5248,208,24720,39311
30,145,"ver","SAYULA DE ALEMAN",5608,3869,4091,127,13695,21173
30,146,"ver","SOCONUSCO",1883,2152,1915,31,5981,9155
30,147,"ver","SOCHIAPA",688,993,157,20,1858,2396
30,148,"ver","SOLEDAD ATZOMPA",3559,676,4984,98,9317,12058
30,149,"ver","SOLEDAD DE DOBLADO",4765,6211,2882,149,14007,21003
30,150,"ver","SOTEAPAN",6800,4852,2891,88,14631,19377
30,151,"ver","TAMALIN",3110,2579,324,50,6063,7744
30,152,"ver","TAMIAHUA",6041,3753,1186,183,11163,16463
30,153,"ver","TAMPICO ALTO",2778,2240,710,51,5779,8865
30,154,"ver","TANCOCO",1319,1047,590,27,2983,4201
30,155,"ver","TANTIMA",3018,2552,514,41,6125,8700
30,156,"ver","TANTOYUCA",19263,23013,4878,355,47509,64363
30,157,"ver","TATATILA",1098,1137,205,30,2470,3308
30,158,"ver","TECOLUTLA",5023,3481,3946,243,12693,17673
30,159,"ver","TEHUIPANGO",2782,2906,3245,52,8985,12346
30,160,"ver","TEMPOAL",7773,4620,3442,188,16023,24208
30,161,"ver","TENAMPA",1130,1559,252,23,2964,4395
30,162,"ver","TENOCHTITLAN",1365,884,389,10,2648,3685
30,163,"ver","TEOCELO",2221,2202,2952,144,7519,11412
30,164,"ver","TEPATLAXCO",1773,2099,366,25,4263,5630
30,165,"ver","TEPETLAN",1294,2243,916,44,4497,6536
30,166,"ver","TEPETZINTLA",3024,2568,1213,63,6868,9311
30,167,"ver","TEQUILA",1957,2057,1549,71,5634,8206
30,168,"ver","JOSE AZUETA",5027,3946,2269,92,11334,17851
30,169,"ver","TEXCATEPEC",2201,724,1981,5,4911,6040
30,170,"ver","TEXHUACAN",1204,508,473,26,2211,3379
30,171,"ver","TEXISTEPEC",3031,4289,2177,51,9548,14066
30,172,"ver","TEZONAPA",8767,6746,7797,218,23528,35162
30,173,"ver","TIERRA BLANCA",13962,21310,9568,617,45457,70650
30,174,"ver","TIHUATLAN",12964,13170,7167,675,33976,58231
30,175,"ver","TLACOJALPAN",879,896,526,24,2325,3652
30,176,"ver","TLACOLULAN",1309,2453,931,53,4746,6400
30,177,"ver","TLACOTALPAN",2446,3392,1235,83,7156,10252
30,178,"ver","TLACOTEPEC DE MEJIA",981,878,176,16,2051,2808
30,179,"ver","TLACHICHILCO",2525,2605,518,35,5683,7571
30,180,"ver","TLALIXCOYAN",6444,8078,2521,204,17247,26223
30,181,"ver","TLALNELHUAYOCAN",1693,2013,2289,151,6146,10219
30,182,"ver","TLAPACOYAN",7647,7679,6431,596,22353,38070
30,183,"ver","TLAQUILPA",1088,842,978,15,2923,4386
30,184,"ver","TLILAPAN",760,866,694,20,2340,3102
30,185,"ver","TOMATLAN",1071,1703,765,54,3593,4967
30,186,"ver","TONAYAN",884,1156,390,9,2439,3456
30,187,"ver","TOTUTLA",3578,4023,785,66,8452,11255
30,188,"ver","TUXPAN",24172,19213,12742,1452,57579,95429
30,189,"ver","TUXTILLA",846,590,91,9,1536,1919
30,190,"ver","URSULO GALVAN",4769,6357,3878,175,15179,23036
30,191,"ver","VEGA DE ALATORRE",4074,2829,1867,152,8922,14693
30,192,"ver","VERACRUZ",59890,123142,67975,3872,254879,411216
30,193,"ver","VILLA ALDAMA",1550,1777,933,84,4344,6455
30,194,"ver","XICO",4532,3800,6253,232,14817,22505
30,195,"ver","XOXOCOTLA",1105,682,576,8,2371,3074
30,196,"ver","YANGA",2998,2710,3009,91,8808,13575
30,197,"ver","YECUATLA",2233,2055,1520,40,5848,8853
30,198,"ver","ZACUALPAN",1078,573,1593,17,3261,4479
30,199,"ver","ZARAGOZA",2201,540,2170,29,4940,6852
30,200,"ver","ZENTLA",2778,3316,717,84,6895,9155
30,201,"ver","ZONGOLICA",6437,5053,6741,197,18428,27656
30,202,"ver","ZONTECOMATLAN",2207,3073,715,24,6019,8057
30,203,"ver","ZOZOCOLCO DE HIDALGO",2438,3230,342,71,6081,8047
30,204,"ver","TRES VALLES",8009,7017,5653,338,21017,32815
30,205,"ver","NANCHITAL DE LAZARO CARDENAS DEL RIO",6054,1159,7542,126,14881,20582
30,206,"ver","AGUA DULCE",7007,2875,12313,175,22370,32894
30,207,"ver","EL HIGO",4944,2732,1930,158,9764,13707
31,1,"yuc","ABALA",2001,1647,180,20,3848,4415
31,2,"yuc","ACANCEH",3683,3902,1257,81,8923,10529
31,3,"yuc","AKIL",2603,2013,939,21,5576,7112
31,4,"yuc","BACA",1629,1658,331,32,3650,4233
31,5,"yuc","BOKOBA",915,767,70,4,1756,1945
31,6,"yuc","BUCTZOTZ",2390,2988,321,12,5711,6505
31,7,"yuc","CACALCHEN",2129,1941,301,55,4426,5154
31,8,"yuc","CALOTMUL",1283,1194,227,13,2717,3070
31,9,"yuc","CANSAHCAB",1418,1044,436,276,3174,3697
31,10,"yuc","CANTAMAYEC",680,674,41,1,1396,1531
31,11,"yuc","CELESTUN",1671,763,1175,48,3657,4509
31,12,"yuc","CENOTILLO",1264,1180,58,8,2510,3037
31,13,"yuc","CONKAL",2930,1972,545,72,5519,6648
31,14,"yuc","CUNCUNUL",516,433,239,0,1188,1276
31,15,"yuc","CUZAMA",1390,1176,244,14,2824,3419
31,16,"yuc","CHACSINKIN",932,773,23,0,1728,1864
31,17,"yuc","CHANKOM",1627,1310,62,2,3001,3234
31,18,"yuc","CHAPAB",1079,823,186,6,2094,2581
31,19,"yuc","CHEMAX",7645,7753,1230,27,16655,18735
31,20,"yuc","CHICXULUB PUEBLO",1296,1014,177,14,2501,2884
31,21,"yuc","CHICHIMILA",2017,1349,438,1026,4830,5319
31,22,"yuc","CHIKINDZONOT",1414,1111,62,3,2590,2777
31,23,"yuc","CHOCHOLA",1354,1201,307,12,2874,3351
31,24,"yuc","CHUMAYEL",831,1062,149,2,2044,2375
31,25,"yuc","DZAN",1208,1360,530,15,3113,3543
31,26,"yuc","DZEMUL",1327,1188,109,7,2631,2865
31,27,"yuc","DZIDZANTUN",2360,1553,1101,96,5110,6277
31,28,"yuc","DZILAM DE BRAVO",908,541,238,3,1690,1918
31,29,"yuc","DZILAM GONZALEZ",1961,1599,346,11,3917,4426
31,30,"yuc","DZITAS",1168,1059,107,8,2342,2616
31,31,"yuc","DZONCAUICH",985,1012,85,4,2086,2452
31,32,"yuc","ESPITA",4069,3343,415,20,7847,9472
31,33,"yuc","HALACHO",5382,5042,1236,53,11713,13373
31,34,"yuc","HOCABA",1564,1385,505,96,3550,4283
31,35,"yuc","HOCTUN",1424,1147,973,27,3571,4337
31,36,"yuc","HOMUN",2291,1969,299,20,4579,5218
31,37,"yuc","HUHI",1277,1581,192,24,3074,3606
31,38,"yuc","HUNUCMA",6441,6921,2479,367,16208,20789
31,39,"yuc","IXIL",1202,968,171,21,2362,2674
31,40,"yuc","IZAMAL",6923,6250,1905,88,15166,18304
31,41,"yuc","KANASIN",15481,10414,4782,572,31249,48858
31,42,"yuc","KANTUNIL",1617,1247,223,19,3106,3771
31,43,"yuc","KAUA",889,733,102,7,1731,1865
31,44,"yuc","KINCHIL",1879,1762,228,25,3894,4419
31,45,"yuc","KOPOMA",998,385,157,11,1551,1903
31,46,"yuc","MAMA",864,880,185,3,1932,2235
31,47,"yuc","MANI",1633,1524,199,8,3364,3927
31,48,"yuc","MAXCANU",5459,4593,2125,64,12241,15141
31,49,"yuc","MAYAPAN",922,937,11,3,1873,1991
31,50,"yuc","MERIDA",161029,157260,91655,9416,419360,588992
31,51,"yuc","MOCOCHA",1047,941,129,15,2132,2412
31,52,"yuc","MOTUL",8141,8118,1928,295,18482,23591
31,53,"yuc","MUNA",3036,3000,844,41,6921,9265
31,54,"yuc","MUXUPIP",1241,643,112,13,2009,2219
31,55,"yuc","OPICHEN",1627,1522,457,14,3620,4261
31,56,"yuc","OXKUTZCAB",5551,4872,4158,116,14697,20332
31,57,"yuc","PANABA",2308,2225,210,16,4759,5331
31,58,"yuc","PETO",5388,4651,1505,266,11810,15511
31,59,"yuc","PROGRESO",13127,6218,6190,781,26316,38849
31,60,"yuc","QUINTANA ROO",451,331,95,2,879,987
31,61,"yuc","RIO LAGARTOS",1049,993,255,16,2313,2567
31,62,"yuc","SACALUM",1398,1414,162,12,2986,3340
31,63,"yuc","SAMAHIL",1523,1073,630,14,3240,3625
31,64,"yuc","SANAHCAT",769,431,39,5,1244,1346
31,65,"yuc","SAN FELIPE",672,720,61,8,1461,1554
31,66,"yuc","SANTA ELENA",1145,981,74,5,2205,2743
31,67,"yuc","SEYE",2091,2168,1081,32,5372,6629
31,68,"yuc","SINANCHE",1123,833,134,13,2103,2388
31,69,"yuc","SOTUTA",2067,1260,1048,26,4401,5468
31,70,"yuc","SUCILA",1354,969,116,8,2447,2770
31,71,"yuc","SUDZAL",516,394,283,1,1194,1335
31,72,"yuc","SUMA",809,265,286,10,1370,1691
31,73,"yuc","TAHDZIU",965,475,631,5,2076,2245
31,74,"yuc","TAHMEK",774,1067,775,16,2632,2957
31,75,"yuc","TEABO",1877,1348,216,1,3442,3996
31,76,"yuc","TECOH",4601,3820,681,51,9153,11254
31,77,"yuc","TEKAL DE VENEGAS",663,860,220,3,1746,2068
31,78,"yuc","TEKANTO",1320,1052,245,29,2646,2976
31,79,"yuc","TEKAX",8427,7158,5001,122,20708,26706
31,80,"yuc","TEKIT",2993,3146,106,20,6265,6991
31,81,"yuc","TEKOM",1251,617,166,5,2039,2204
31,82,"yuc","TELCHAC PUEBLO",1156,835,194,216,2401,2873
31,83,"yuc","TELCHAC PUERTO",444,534,135,204,1317,1482
31,84,"yuc","TEMAX",2210,2073,189,8,4480,5135
31,85,"yuc","TEMOZON",3315,2531,1331,1111,8288,9601
31,86,"yuc","TEPAKAN",776,271,731,4,1782,2001
31,87,"yuc","TETIZ",1349,1001,503,56,2909,3408
31,88,"yuc","TEYA",742,315,185,5,1247,1533
31,89,"yuc","TICUL",8565,7238,3540,257,19600,25836
31,90,"yuc","TIMUCUY",1822,2380,105,10,4317,4721
31,91,"yuc","TINUM",2382,3173,1208,43,6806,7303
31,92,"yuc","TIXCACALCUPUL",1924,1469,164,3,3560,4047
31,93,"yuc","TIXKOKOB",4188,4314,1789,149,10440,12564
31,94,"yuc","TIXMEHUAC",1338,258,1290,6,2892,3164
31,95,"yuc","TIXPEHUAL",1588,1359,534,38,3519,4113
31,96,"yuc","TIZIMIN",16491,15215,3429,380,35515,47493
31,97,"yuc","TUNKAS",1056,1313,63,3,2435,2855
31,98,"yuc","TZUCACAB",2472,3089,1659,27,7247,8796
31,99,"yuc","UAYMA",1089,1053,90,82,2314,2483
31,100,"yuc","UCU",1058,732,135,31,1956,2439
31,101,"yuc","UMAN",10111,9147,4523,397,24178,33789
31,102,"yuc","VALLADOLID",15592,12077,7969,407,36045,47214
31,103,"yuc","XOCCHEL",816,554,552,46,1968,2353
31,104,"yuc","YAXCABA",3890,3762,238,6,7896,9187
31,105,"yuc","YAXKUKUL",1218,303,311,24,1856,2169
31,106,"yuc","YOBAIN",683,617,278,21,1599,1794
32,1,"zac","APOZOL",1437,784,566,68,2855,5494
32,2,"zac","APULCO",1556,495,256,34,2341,4122
32,3,"zac","ATOLINGA",727,394,221,58,1400,2605
32,4,"zac","BENITO JUAREZ",904,894,186,49,2033,3437
32,5,"zac","CALERA",7587,3428,2869,755,14639,25585
32,6,"zac","CA�ITAS DE FELIPE PESCADOR",1797,644,1108,94,3643,6012
32,7,"zac","CONCEPCION DEL ORO",3211,1301,1521,107,6140,8996
32,8,"zac","CUAUHTEMOC",2714,851,1126,112,4803,8169
32,9,"zac","CHALCHIHUITES",2459,1217,725,117,4518,8508
32,10,"zac","FRESNILLO",46806,12155,30246,3251,92458,149098
32,11,"zac","TRINIDAD GARCIA DE LA CADENA",755,444,264,27,1490,2807
32,12,"zac","GENARO CODINA",2148,736,489,95,3468,5708
32,13,"zac","GENERAL ENRIQUE ESTRADA",1402,702,569,109,2782,4392
32,14,"zac","GENERAL FRANCISCO R. MURGUIA",6058,1781,2123,165,10127,17465
32,15,"zac","EL PLATEADO DE JOAQUIN AMARO",531,87,404,8,1030,1756
32,16,"zac","GENERAL PANFILO NATERA",5077,1554,2842,261,9734,16642
32,17,"zac","GUADALUPE",29807,10057,19146,2957,61967,101415
32,57,"zac","TRANCOSO",3767,520,1812,122,6221,11000
32,18,"zac","HUANUSCO",1198,1172,414,36,2820,3855
32,19,"zac","JALPA",5009,3385,2074,282,10750,18636
32,20,"zac","JEREZ",12259,5994,5884,1219,25356,46595
32,21,"zac","JIMENEZ DEL TEUL",975,464,298,57,1794,3356
32,22,"zac","JUAN ALDAMA",4495,2216,1895,271,8877,14969
32,23,"zac","JUCHIPILA",3082,1376,1546,200,6204,10789
32,24,"zac","LORETO",9529,2038,6191,586,18344,31076
32,25,"zac","LUIS MOYA",3236,915,1213,206,5570,8865
32,26,"zac","MAZAPIL",4888,1125,1928,45,7986,12878
32,27,"zac","MELCHOR OCAMPO",738,100,554,5,1397,2215
32,28,"zac","MEZQUITAL DEL ORO",693,460,337,12,1502,2342
32,29,"zac","MIGUEL AUZA",4620,1568,1605,165,7958,15309
32,30,"zac","MOMAX",693,511,121,19,1344,2300
32,31,"zac","MONTE ESCOBEDO",2314,1388,652,123,4477,7604
32,32,"zac","MORELOS",3426,778,984,232,5420,8186
32,33,"zac","MOYAHUA DE ESTRADA",1240,735,420,36,2431,4524
32,34,"zac","NOCHISTLAN DE MEJIA",6509,4602,1976,493,13580,23300
32,35,"zac","NORIA DE ANGELES",3568,740,1609,175,6092,10619
32,36,"zac","OJOCALIENTE",8648,2933,2762,626,14969,27752
32,37,"zac","PANUCO",4258,1284,824,162,6528,11046
32,38,"zac","PINOS",19641,6869,4298,480,31288,47139
32,39,"zac","RIO GRANDE",14979,5730,6302,842,27853,46685
32,40,"zac","SAIN ALTO",4030,2367,2174,208,8779,15384
32,41,"zac","EL SALVADOR",850,104,375,5,1334,2163
32,42,"zac","SOMBRERETE",14431,4564,5040,880,24915,46116
32,43,"zac","SUSTICACAN",268,188,248,22,726,1189
32,44,"zac","TABASCO",3626,2303,1243,190,7362,11987
32,45,"zac","TEPECHITLAN",2095,764,1062,59,3980,7006
32,46,"zac","TEPETONGO",2253,588,803,92,3736,6445
32,47,"zac","TEUL DE GONZALEZ ORTEGA",1361,733,563,38,2695,4500
32,58,"zac","SANTA MARIA DE LA PAZ",595,409,332,25,1361,2429
32,48,"zac","TLALTENANGO DE SANCHEZ ROMAN",6102,2475,2417,297,11291,18774
32,49,"zac","VALPARAISO",7933,4133,2835,446,15347,26509
32,50,"zac","VETAGRANDE",2474,530,1262,122,4388,6932
32,51,"zac","VILLA DE COS",8956,1738,3379,308,14381,24114
32,52,"zac","VILLA GARCIA",4368,827,2738,225,8158,11942
32,53,"zac","VILLA GONZALEZ ORTEGA",2994,794,1718,111,5617,9573
32,54,"zac","VILLA HIDALGO",3996,1676,2195,239,8106,12617
32,55,"zac","VILLANUEVA",7750,3101,2878,358,14087,24571
32,56,"zac","ZACATECAS",29798,10472,20169,3156,63595,99950
